5 5 5 5 5 5 5 5 -6 -6 -6 -6 -6 -6 -6 -6 -6 -6 -6 -6 -6 -6 5 5 5 5 5 5 5 5 
5 5 5 5 5 5 5 5 -6 -2 -6 -6 -6 -6 -6 -6 -6 -6 -6 -6 -6 -2 5 5 5 5 5 5 5 5 
5 5 5 5 5 5 5 5 -6 -6 -6 5 5 5 5 5 5 5 5 -6 -6 -6 5 5 5 5 5 5 5 5 
5 5 5 5 5 5 5 5 -6 -2 -6 5 5 5 5 5 5 5 5 -6 -6 -2 5 5 5 5 5 5 5 5 
5 5 5 5 5 5 5 5 -6 -6 -6 5 -6 -6 -6 -6 -6 5 5 -6 -6 -6 5 5 5 5 5 5 5 5 
5 5 5 5 5 5 5 5 -6 -2 -6 5 -6 5 5 5 -6 5 5 -6 -6 -2 5 5 5 5 5 5 5 5 
5 5 5 5 5 5 5 5 -6 -6 -6 5 -6 5 5 5 -6 5 5 -6 -6 -6 5 5 5 5 5 5 5 5 
5 5 5 5 5 5 5 5 -6 -2 -6 5 -6 5 5 5 -6 5 5 -6 -6 -2 5 5 5 5 5 5 5 5 
-6 -6 -6 -6 -6 -6 -6 -6 -6 -6 -6 5 5 5 5 5 5 5 5 -6 -6 -6 -6 -6 -6 -6 -6 -6 -6 -6 
-6 -2 -6 -2 -6 -2 -6 -2 -6 -2 -6 5 5 5 5 5 5 5 5 -33 -6 -2 -6 -2 -6 -2 -6 -2 -6 -2 
-6 -6 -6 -6 -6 -6 -6 -6 -6 5 5 5 5 5 5 5 5 5 5 5 -6 -6 -6 -6 -6 -6 -6 -6 -6 -6 
-6 5 5 5 -6 -6 -6 5 5 5 5 5 5 5 5 5 5 5 5 5 5 5 5 -6 -6 5 5 5 -6 -6 
-6 5 5 5 5 5 5 5 5 -6 -6 5 -6 -6 -6 -6 -6 -6 -6 -6 5 5 5 -6 5 5 5 5 -6 -6 
-6 -6 -6 5 5 5 5 5 5 -6 -6 5 -6 -6 -6 -6 -6 -6 -6 -6 5 5 5 5 5 -6 -6 -6 -6 -6 
-6 5 5 -6 -6 -6 5 5 5 5 5 5 5 5 5 5 5 5 5 -6 5 5 5 5 5 -6 5 5 5 5 
-6 5 5 5 5 5 5 5 5 -6 -6 5 -6 -6 -6 -6 -6 -6 -6 -6 5 5 5 5 5 -6 -6 5 5 5 
-6 5 5 5 5 5 5 5 5 5 5 5 5 5 5 5 5 5 5 5 5 5 5 5 5 5 -6 5 5 5 
-6 5 5 -6 -6 -6 5 5 5 5 5 5 5 5 5 5 5 5 5 5 5 5 5 5 5 5 -6 -6 5 5 
-6 5 5 -6 -6 -6 5 5 -6 5 5 5 -6 -6 -6 5 5 5 5 5 5 -6 -6 -6 5 5 5 -6 5 5 
-6 5 5 5 5 5 5 5 5 23 5 5 -6 -6 -6 5 5 5 5 24 5 -6 -6 -6 5 5 -6 5 5 -34 
-6 5 5 5 5 5 5 5 5 5 5 5 5 5 5 5 5 5 5 5 5 5 5 5 5 5 -6 5 5 5 
-6 5 5 5 5 5 5 5 5 5 5 5 5 5 5 5 5 5 5 5 5 5 5 5 5 5 -6 5 5 5 
-6 5 5 5 5 5 5 5 5 5 5 5 5 5 5 5 5 5 5 5 5 5 5 5 5 5 -6 5 5 5 
-6 5 5 5 5 5 5 5 5 -6 -6 -6 5 5 5 -6 -6 -6 5 5 5 5 5 5 5 5 -6 5 5 5 
-6 5 5 5 5 5 5 5 5 -6 -6 -6 5 5 5 -6 -6 -6 5 5 5 5 -6 5 5 5 -6 5 5 5 
-6 5 5 5 5 5 5 5 5 -6 -6 -6 5 5 5 5 5 5 5 5 5 5 5 5 5 5 -6 5 5 5 
-6 5 5 5 5 5 5 5 5 5 5 5 5 5 5 5 5 5 5 5 5 5 5 5 5 5 -6 5 5 5 
-6 5 5 5 5 5 5 5 5 5 5 5 5 5 5 5 5 5 5 5 5 5 5 5 5 5 -6 -6 -6 -6 
-6 5 5 5 5 5 5 5 5 5 5 5 5 5 5 5 5 5 5 5 5 5 5 -6 -6 5 5 5 5 -6 
-6 -6 -6 -6 -6 -6 -6 -6 -6 -35 -6 -6 -6 -6 -6 -6 -6 -6 -6 -36 -6 -6 -6 -6 -6 -6 -6 -6 -6 -37 
