5 5 5 5 5 5 5 5 5 5 5 5 5 5 5 5 5 5 5 5 5 5 5 5 5 5 5 5 5 5 5 5 5 5 5 5 5 5 5 5 
5 5 5 5 5 5 5 5 5 5 5 5 5 5 5 5 5 5 5 5 5 5 5 5 5 5 5 5 5 5 5 5 5 5 5 5 5 5 5 5 
5 5 -6 -6 -6 -6 -6 -6 -6 -6 -6 -6 -6 -6 -6 -6 -6 -6 -6 -6 -6 -6 -6 -6 -6 -6 -6 -6 -6 -6 -6 -6 -6 -6 -6 -6 -6 -6 -6 5 
5 5 -6 5 5 5 5 5 5 -6 5 5 5 5 5 5 -6 5 5 5 5 5 -6 5 5 5 5 5 -6 5 5 5 5 5 5 5 5 -6 5 5 
5 5 -6 5 5 -6 5 5 5 -6 5 -6 5 5 5 5 -6 5 5 -6 5 5 5 -6 5 5 5 5 -6 5 5 -6 -6 -6 5 5 5 -6 5 5 
5 5 -6 5 5 5 5 5 5 -6 5 5 5 -6 5 5 -6 5 5 -6 5 5 -6 5 5 5 -6 5 -6 5 5 -6 5 5 -6 5 5 -6 5 5 
5 5 -6 5 5 5 5 5 5 -6 5 5 5 -6 5 5 -6 5 5 -6 5 5 5 5 5 -6 5 5 5 -6 5 -6 5 5 -6 5 5 -6 5 5 
5 5 -6 -6 -6 -6 -6 5 5 -6 5 5 5 -6 5 5 5 5 5 -6 5 5 5 5 -6 -6 5 5 -6 5 5 -6 5 5 -6 5 5 -6 5 5 
5 5 -6 5 5 5 5 5 5 -6 5 5 5 -6 5 5 5 5 5 -6 5 5 -6 5 5 5 5 5 5 -6 5 5 -6 5 5 5 5 -6 5 5 
5 5 -6 5 5 5 5 5 5 -96 5 5 5 -6 5 5 5 5 -6 -97 5 5 5 -6 5 5 5 5 5 -98 5 -6 5 5 -6 5 5 -6 5 -99 
5 5 -6 5 5 5 5 5 5 -6 5 5 5 -6 5 5 5 -6 5 5 5 5 5 5 -6 5 5 -6 -6 5 5 5 5 5 5 5 5 -6 5 5 
5 5 -6 5 5 -6 5 5 5 5 5 5 5 -6 5 5 -6 5 5 5 5 -6 5 5 -6 5 5 5 5 5 5 -6 5 -6 5 -6 5 -6 5 5 
5 5 -6 5 5 -6 5 5 5 5 5 5 5 -6 5 -6 5 5 -6 5 5 5 -6 5 -6 5 5 5 -6 5 5 5 5 5 5 5 5 -6 5 5 
5 5 -6 5 5 -6 5 5 -6 -6 -6 -6 -6 -6 5 5 5 5 5 -6 5 5 5 5 -6 5 5 5 -6 5 5 -6 5 5 5 -6 5 -6 5 5 
5 5 -6 5 5 -6 5 5 5 5 5 5 5 -6 5 -6 5 5 -6 5 5 5 5 5 -6 5 -6 5 -6 5 5 5 -6 5 -6 5 5 -6 5 5 
5 5 -6 5 5 5 -6 5 5 5 5 5 5 5 5 5 5 5 5 -6 5 5 5 5 5 5 5 5 -6 5 5 5 5 5 5 5 5 -6 5 5 
5 5 -6 -6 -6 -6 -6 -6 -6 -6 -6 -6 -6 -6 -6 -6 -6 -6 -6 -6 -6 -6 -6 -6 -6 -6 -6 -6 -6 -6 -6 -6 -6 -6 -6 -6 -6 -6 5 5 
5 5 5 5 5 5 5 5 5 5 5 5 5 5 5 5 5 5 5 5 5 5 5 5 5 5 5 5 5 5 5 5 5 5 5 5 5 5 5 5 
5 5 5 5 5 5 5 5 5 5 5 5 5 5 5 5 5 5 5 5 5 5 5 5 5 5 5 5 5 5 5 5 5 5 5 5 5 5 5 5 
5 5 5 5 5 5 5 5 5 -100 5 5 5 5 5 5 5 5 5 -101 5 5 5 5 5 5 5 5 5 -102 5 5 5 5 5 5 5 5 5 -103 
-6 -6 -6 -6 -6 -6 -6 -6 -6 -6 -6 -6 -6 -6 -6 -6 -6 -6 -6 -6 -6 -6 -6 -6 -6 -6 -6 -6 -6 -6 -6 -6 -6 -6 -6 -6 -6 -6 -6 -6 
-6 5 5 5 5 5 5 5 5 5 5 5 5 5 5 5 5 5 5 5 5 5 5 5 5 5 5 5 5 5 5 5 5 5 5 5 5 5 5 -6 
-6 5 5 0 0 0 0 5 5 5 5 5 5 5 5 5 5 5 5 5 5 0 0 0 0 0 0 0 0 5 5 5 5 5 5 5 5 5 5 -6 
-6 5 5 0 5 5 0 0 5 5 0 0 0 0 0 0 0 0 0 0 0 0 5 5 5 0 5 5 0 5 0 0 0 0 0 0 0 5 5 -6 
-6 5 5 0 5 5 5 0 0 0 0 5 5 5 5 5 0 5 5 0 0 5 5 5 5 5 5 5 0 0 0 5 5 5 5 5 0 5 5 -6 
-6 5 5 0 0 0 5 5 5 0 0 5 5 5 0 5 5 5 5 0 0 5 5 5 5 5 5 5 5 0 0 5 5 5 5 5 0 5 5 -6 
-6 5 5 5 5 0 0 5 5 0 5 5 5 5 5 5 5 5 5 5 5 5 5 5 5 5 5 5 5 5 0 5 5 5 5 0 0 5 5 -6 
-6 5 5 5 0 0 0 5 5 0 5 5 5 5 5 5 5 5 5 5 5 5 5 5 5 5 5 5 5 5 0 0 5 0 0 0 0 0 5 -6 
-6 5 5 5 0 5 5 5 0 0 5 5 5 5 5 5 5 5 5 5 5 5 5 5 5 5 5 5 5 5 0 0 5 5 0 5 5 0 5 -6 
-6 5 5 5 0 5 5 0 0 -104 5 5 5 5 5 5 5 5 5 47 5 5 5 5 5 5 5 5 5 48 0 5 5 5 5 5 0 0 5 -105 
-6 5 5 5 0 5 5 0 5 0 5 5 5 5 5 5 5 5 5 5 5 5 5 5 5 5 5 5 5 5 5 0 5 5 0 5 5 5 5 -6 
-6 5 5 5 0 5 5 0 0 0 5 5 5 5 5 5 5 5 5 5 5 5 5 5 5 5 5 5 5 5 0 0 5 5 0 0 0 5 5 -6 
-6 5 5 0 0 0 5 0 5 5 5 5 5 5 5 5 5 5 5 5 5 5 5 5 5 5 5 5 5 5 0 5 5 5 5 5 0 5 5 -6 
-6 5 5 0 5 5 5 0 5 5 5 5 5 5 5 5 5 5 5 5 5 5 5 5 5 5 5 5 5 5 5 5 5 5 5 5 0 5 5 -6 
-6 5 5 0 5 5 5 5 5 0 5 5 5 5 5 5 5 5 5 5 5 5 5 5 5 5 5 5 5 5 5 5 0 5 0 0 0 5 5 -6 
-6 5 5 0 0 0 0 0 0 0 5 5 5 5 5 5 5 5 5 5 5 5 5 5 5 5 5 5 5 5 0 0 0 5 5 5 0 5 5 -6 
-6 5 5 5 5 5 5 5 5 5 5 5 0 0 0 0 0 0 0 0 0 0 0 0 0 0 0 0 0 0 5 5 0 0 0 0 0 5 5 -6 
-6 5 5 5 5 5 5 5 5 5 5 5 5 5 5 5 5 5 5 5 5 5 5 5 5 5 5 5 5 5 5 5 5 5 5 5 5 5 5 -6 
-6 5 5 5 5 5 5 5 5 5 5 5 5 5 5 5 5 5 5 5 5 5 5 5 5 5 5 5 5 5 5 5 5 5 5 5 5 5 5 -6 
-6 -6 -6 -6 -6 -6 -6 -6 -6 -106 -6 -6 -6 -6 -6 -6 -6 -6 -6 -107 -6 -6 -6 -6 -6 -6 -6 -6 -6 -108 -6 -6 -6 -6 -6 -6 -6 -6 -6 -109 
