-1 -1 -1 -1 -1 -1 -1 -1 -1 -1 
-1 5 5 5 5 5 5 5 5 -1 
-1 5 18 22 22 22 22 16 5 -1 
-1 5 10 10 10 10 10 10 5 -1 
-1 5 10 10 10 10 10 10 5 -1 
-1 5 10 10 10 10 10 10 5 -1 
-1 5 10 10 10 10 10 10 5 -1 
-1 5 14 19 19 19 19 12 5 -1 
-1 5 5 5 5 5 5 5 5 -1 
-1 -1 -1 -1 -1 -1 -1 -1 -1 -1 
