105 105 105 105 105 105 105 105 105 105 105 105 105 105 105 105 105 105 105 105 105 105 105 105 105 105 105 105 105 105 105 105 105 105 105 105 105 105 105 105 
105 105 105 105 105 105 105 105 105 105 105 101 105 105 105 105 105 105 105 105 105 105 105 105 104 105 105 105 105 105 105 105 105 105 105 105 105 105 105 105 
105 105 105 112 105 112 101 105 105 105 105 105 105 105 105 105 105 105 105 105 105 105 105 105 104 105 105 105 105 105 105 105 105 105 105 104 105 105 105 105 
105 105 105 105 105 105 105 105 105 105 105 105 105 105 105 105 105 105 105 105 105 105 105 105 105 105 105 105 105 105 105 105 105 105 105 105 104 105 105 105 
105 105 105 105 105 105 105 105 105 105 105 105 105 105 105 105 105 105 105 105 105 105 105 105 105 105 105 105 105 105 105 105 105 105 105 105 105 104 105 105 
105 105 105 105 105 105 105 105 101 105 105 105 105 105 105 105 105 105 105 105 105 105 105 105 105 105 105 105 109 105 105 105 105 105 105 105 105 105 105 105 
105 105 105 105 105 105 105 105 105 105 105 105 105 105 105 105 105 105 105 105 105 105 105 117 105 105 105 105 100 105 105 105 105 105 105 102 102 102 105 105 
105 105 105 105 105 105 105 105 105 105 105 105 105 105 105 105 105 105 105 105 105 105 105 105 105 105 105 105 105 105 105 105 105 105 105 102 117 102 117 105 
105 105 105 105 105 105 105 105 105 105 105 105 105 105 105 105 105 105 105 104 105 117 105 105 105 105 117 105 105 105 117 102 102 102 102 102 117 102 117 105 
105 105 105 105 105 105 105 105 105 105 105 105 105 105 105 105 105 104 117 105 105 105 105 117 105 105 105 105 117 105 102 102 117 117 117 117 117 102 117 105 
105 105 105 105 105 105 105 105 105 105 102 102 102 102 102 102 117 117 117 117 117 117 117 117 117 117 102 102 102 102 102 102 102 102 102 117 117 102 102 105 
105 105 105 105 105 105 105 105 105 111 102 117 105 105 105 102 102 102 102 102 102 102 102 102 102 105 102 105 105 117 117 117 117 117 102 105 105 117 102 105 
105 105 105 105 105 105 105 105 105 105 102 117 117 105 105 105 105 105 105 105 117 105 105 105 102 105 102 105 111 117 105 105 105 117 102 102 102 105 102 105 
105 105 105 105 105 105 105 105 105 105 102 102 102 117 117 117 117 117 117 117 117 117 105 105 102 102 102 117 117 117 105 105 105 117 117 117 102 102 102 105 
105 105 105 105 105 105 105 105 105 105 117 105 102 117 102 102 102 105 105 105 105 117 117 117 117 117 117 117 105 105 105 105 102 102 102 117 117 117 105 105 
105 105 105 105 105 105 105 105 105 105 117 117 102 102 102 105 102 102 102 102 102 102 102 102 102 102 102 102 102 102 102 102 102 117 102 102 102 117 105 105 
105 105 105 105 105 105 105 105 105 105 105 111 105 105 117 117 117 117 117 117 117 117 117 117 117 117 117 117 117 117 117 117 117 117 105 117 102 117 105 105 
105 105 105 105 105 105 105 105 105 105 105 105 105 105 105 105 105 105 105 105 105 105 105 105 105 105 105 105 105 105 105 105 105 105 105 105 102 117 105 105 
105 105 105 105 105 105 105 105 105 105 105 105 105 105 105 105 105 105 105 105 105 105 105 105 105 105 105 105 105 105 105 105 105 105 105 117 102 117 105 105 
105 105 105 105 105 105 105 105 105 105 105 105 105 105 105 105 105 105 105 105 105 105 105 105 105 105 105 105 105 105 105 105 105 105 105 105 102 117 105 105 
105 105 105 105 105 105 105 105 105 105 105 105 105 105 105 105 105 105 105 105 105 105 105 105 105 105 105 105 105 105 105 105 105 105 105 105 102 117 105 105 
105 105 105 105 105 105 105 105 105 105 105 105 105 105 105 105 105 105 105 105 105 105 105 105 105 105 105 105 105 105 105 105 105 105 105 105 102 117 105 105 
105 105 105 105 105 105 105 105 105 105 105 105 105 105 105 105 105 105 105 105 105 105 105 105 105 105 105 105 105 105 105 105 105 105 105 105 102 117 117 117 
105 104 105 105 105 105 105 105 105 105 105 105 105 105 105 105 105 104 105 105 105 105 117 117 117 117 105 105 105 105 105 105 105 105 105 105 102 102 102 117 
105 104 105 105 105 105 105 105 105 104 104 105 105 105 105 105 105 104 105 105 105 105 105 105 105 105 117 105 105 105 105 105 105 117 117 117 117 117 102 117 
105 105 105 105 105 105 105 105 105 105 105 105 105 105 105 105 105 105 105 105 105 105 102 102 102 102 102 117 117 117 105 105 105 117 102 102 102 117 102 117 
105 105 105 105 105 105 105 105 105 105 105 105 105 105 105 105 105 105 105 105 105 105 102 117 117 117 102 105 117 117 117 117 117 117 102 117 102 117 102 117 
105 105 105 105 105 105 105 105 105 105 105 105 105 105 105 105 105 105 105 105 105 105 102 117 105 117 102 102 102 102 102 102 102 102 102 117 102 102 102 105 
105 105 105 105 105 105 105 105 105 105 105 105 105 105 105 105 105 105 105 105 105 105 102 105 105 105 117 117 117 117 117 117 117 117 117 117 117 105 105 105 
105 105 105 105 105 105 105 105 105 105 105 105 105 105 105 105 105 105 105 105 105 105 102 117 105 105 105 105 105 105 105 105 105 105 105 105 105 105 105 105 
105 105 105 105 105 105 105 105 105 105 105 105 105 105 105 105 105 105 105 105 105 105 102 117 105 105 117 117 117 117 117 117 117 117 117 105 105 105 105 105 
105 105 105 105 105 105 105 105 105 105 105 105 105 105 105 105 105 105 105 105 105 105 102 117 117 105 117 102 102 102 102 102 102 102 117 117 117 117 117 117 
105 105 105 105 105 105 105 105 105 105 105 105 105 105 105 105 105 105 105 105 105 105 102 105 117 117 117 102 117 117 117 105 105 102 102 102 102 102 102 117 
105 105 105 105 105 105 105 105 105 105 105 105 105 105 105 105 105 105 105 105 105 105 102 105 105 117 117 102 117 117 105 105 105 117 117 105 105 105 102 117 
105 105 105 105 105 105 105 105 105 105 105 112 105 112 105 105 105 105 105 105 105 105 102 102 102 102 102 102 117 117 105 105 105 117 117 105 105 105 102 117 
105 105 105 105 105 105 105 105 105 105 105 105 105 101 105 105 105 105 105 105 105 105 117 105 105 105 105 105 105 117 117 117 117 117 105 105 105 105 102 117 
105 105 105 105 105 105 105 105 105 105 105 105 105 101 105 105 105 105 105 105 105 105 105 105 105 105 105 105 105 105 105 105 105 105 106 102 102 102 102 117 
105 105 105 105 105 105 105 105 105 105 105 112 105 112 105 105 105 105 105 105 105 105 105 105 105 105 105 105 105 105 105 105 117 105 105 105 105 105 105 117 
105 105 105 105 105 105 109 109 105 105 105 105 105 105 105 105 105 105 105 105 105 105 105 105 105 105 105 105 105 105 105 105 117 105 105 105 105 105 105 117 
105 105 105 105 105 105 105 105 105 105 105 105 105 105 105 105 105 105 105 105 105 105 105 105 105 105 105 105 105 111 105 105 117 105 105 105 105 105 105 117 
