5 5 5 5 5 5 5 5 5 5 5 5 5 5 5 5 5 5 5 5 5 5 5 5 5 5 5 5 5 5 -6 5 5 5 5 5 5 5 5 5 5 5 5 5 5 -6 -6 -6 -6 5 5 5 5 5 5 5 5 5 5 5 5 5 5 5 5 5 5 5 5 5 5 5 5 5 5 5 5 5 5 5 
5 5 -6 -6 -6 -6 -6 -6 -6 -6 -6 -6 -6 -6 -6 -6 -6 -6 5 5 -6 -6 -6 -6 -6 -6 -6 -6 -6 -6 5 -6 -6 -6 5 5 5 5 5 5 5 5 5 5 -6 5 5 5 -6 5 5 5 5 5 5 5 5 5 5 5 5 5 5 5 5 5 5 5 5 5 -6 -6 -6 -6 5 5 5 5 5 5 
5 5 -6 5 5 5 5 5 5 5 5 5 5 5 5 5 5 -6 5 5 -6 5 5 5 5 5 5 5 5 5 5 5 5 -6 5 5 5 5 5 5 5 5 5 -6 -6 5 5 -6 -6 5 -6 -6 -6 -6 -6 -6 -6 -6 -6 -6 -6 -6 -6 -6 -6 -6 -6 -6 -6 -6 5 5 5 -6 5 5 5 5 5 5 
5 5 -6 5 5 5 5 5 5 5 5 5 5 5 5 5 5 -6 5 5 -6 -6 -6 -6 -6 -6 -6 -6 5 -6 -6 -6 -6 -6 5 5 5 5 5 5 5 5 5 -6 -6 5 5 -6 -6 5 -6 5 5 5 5 5 5 5 5 5 5 5 -6 -6 5 5 5 5 5 5 5 5 5 -6 -6 -6 -6 -6 -6 -6 
5 5 -6 5 -6 -6 -6 -6 -6 -6 -6 -6 -6 -6 5 5 5 -6 5 5 5 -6 5 5 5 5 5 5 5 5 5 -6 5 5 5 5 5 5 5 5 5 5 5 -6 5 5 5 5 -6 -6 -6 5 5 5 5 5 5 5 5 5 5 -6 -6 5 5 5 5 5 5 5 5 5 5 5 5 5 5 5 5 -6 
5 5 -6 5 -6 5 5 5 5 5 5 5 5 -6 5 5 5 -6 5 5 5 -6 5 5 5 5 5 5 5 5 5 -6 5 5 5 5 0 5 5 5 5 5 -6 -6 5 5 5 5 5 -6 -6 5 5 5 5 5 5 5 5 5 5 -6 -6 5 5 5 5 5 5 5 5 5 5 5 5 5 5 5 5 -6 
5 5 -6 5 -6 5 5 5 5 5 5 5 5 -6 -6 -6 -6 -6 5 5 5 -6 -6 -6 -6 -6 5 5 5 5 5 0 5 5 5 5 0 5 5 5 5 5 -6 5 5 5 5 5 5 -6 -6 -6 5 5 5 -6 -6 5 5 5 -6 -6 -6 -6 5 5 5 5 5 5 5 5 5 5 5 5 5 5 5 -6 
5 5 -6 -6 -6 5 5 5 5 5 5 5 5 5 5 5 5 5 5 5 -6 5 5 5 5 -6 5 5 5 5 5 0 5 5 5 5 5 5 5 5 5 -6 -6 5 5 5 5 5 5 -6 -6 5 5 5 5 -6 -6 5 5 5 -6 -6 -6 -6 5 5 5 5 5 5 5 5 5 5 5 5 5 -6 -6 -6 
5 5 5 5 5 5 5 5 5 5 5 5 5 5 5 5 5 5 5 5 -6 5 5 5 5 -6 5 5 5 5 5 0 5 5 5 5 5 5 5 5 5 -6 5 5 5 5 5 5 5 5 5 5 5 5 5 5 -6 -6 5 5 5 -6 -6 5 5 5 5 5 5 5 5 -6 -6 -6 -6 -6 -6 -6 -6 -6 
5 5 5 5 5 5 5 5 5 -47 5 5 5 5 5 5 5 5 5 -48 -6 5 -6 -6 -6 -6 5 5 -6 -49 -6 -6 5 5 5 5 5 5 5 -50 5 -6 5 5 5 5 5 5 5 28 5 5 5 5 5 5 -6 -6 5 29 5 5 -6 5 5 5 5 5 5 -51 -6 -6 5 5 5 5 -6 5 -6 -52 
5 5 -6 -6 -6 -6 -6 -6 -6 -6 5 5 5 5 5 5 5 5 5 5 -6 5 -6 5 5 -6 5 5 -6 5 5 5 5 5 5 5 5 5 5 5 5 5 -6 5 5 5 5 5 5 5 5 5 5 5 5 -6 -6 5 5 5 5 5 5 5 5 5 5 5 -6 -6 5 5 5 -6 5 -6 -6 5 -6 5 
5 -6 -6 5 -6 -6 -6 -6 -6 -6 -6 -6 -6 -6 -6 -6 -6 -6 5 5 -6 5 -6 5 5 -6 5 5 -6 5 5 5 5 5 5 5 5 5 5 5 5 5 -6 -6 5 5 5 5 5 5 5 5 5 5 -6 -6 -6 5 5 5 5 5 5 5 5 5 5 5 -6 -6 5 5 5 -6 5 5 5 -6 -6 5 
5 -6 5 5 5 5 5 5 5 5 5 5 5 5 5 5 5 -6 5 5 -6 5 -6 5 5 -6 5 5 -6 5 5 5 5 5 5 5 5 5 5 5 5 5 -6 -6 5 5 5 5 5 5 5 5 5 5 -6 -6 -6 5 5 5 5 5 5 5 5 5 5 -6 -6 -6 5 5 5 -6 5 5 5 -6 5 5 
5 -6 5 5 5 -6 -6 -6 -6 -6 -6 -6 5 5 5 5 5 -6 5 5 -6 5 -6 5 5 -6 5 5 -6 5 5 5 5 5 5 5 5 5 5 5 5 5 -6 5 5 5 -6 -6 -6 5 5 -6 -6 -6 -6 -6 5 5 5 0 5 5 5 5 5 5 5 5 -6 -6 -6 -6 -6 -6 5 5 5 -6 -6 5 
5 -6 5 5 5 -6 5 5 5 5 5 -6 5 5 5 5 5 -6 5 5 -6 5 -6 5 5 -6 5 5 -6 5 5 5 5 5 5 5 5 5 5 5 5 5 -6 5 5 5 -6 -6 -6 5 5 -6 -6 -6 -6 -6 5 5 5 5 5 5 5 5 5 5 5 5 5 -6 -6 5 5 5 5 5 5 5 -6 5 
5 -6 5 5 5 -6 5 5 5 5 5 -6 5 5 5 5 5 -6 5 5 -6 5 -6 5 5 -6 5 5 -6 5 5 5 5 5 5 5 5 5 5 5 5 5 -6 -6 5 5 5 -6 5 5 5 5 -6 -6 -6 -6 5 5 5 5 5 5 5 5 5 5 5 -6 -6 -6 -6 5 5 5 5 -6 -6 -6 -6 5 
5 -6 -6 5 -6 -6 -6 5 5 5 5 -6 -6 -6 -6 -6 -6 -6 5 5 -6 5 -6 5 5 -6 5 5 -6 5 5 5 5 5 5 5 5 5 5 5 5 5 -6 5 5 5 5 5 5 5 5 5 -6 -6 -6 -6 -6 5 5 5 -6 -6 -6 5 5 5 5 -6 -6 -6 5 5 5 5 5 -6 5 5 5 5 
-6 5 5 5 5 5 -6 5 5 5 5 5 5 5 5 5 5 5 5 5 -6 5 -6 5 5 -6 5 5 -6 5 5 5 5 5 5 5 5 5 5 5 5 -6 -6 5 5 5 5 5 5 5 5 5 5 -6 -6 -6 -6 5 5 5 -6 -6 -6 5 5 5 5 5 -6 -6 5 5 5 5 -6 -6 5 5 5 5 
5 -6 -6 5 -6 -6 -6 5 5 5 5 5 5 5 5 5 5 5 5 5 -6 5 -6 5 5 -6 5 5 -6 5 5 5 5 5 5 5 5 5 5 5 5 -6 5 5 5 5 -6 5 5 5 5 5 5 -6 -6 -6 -6 -6 5 5 5 -6 5 5 5 5 5 5 5 5 5 5 5 5 -6 5 5 5 5 5 
5 5 5 -6 5 5 5 5 5 -53 5 5 5 5 5 5 5 5 5 -54 -6 5 -6 5 5 -6 5 5 -6 -55 5 5 5 5 5 5 5 5 5 -56 5 -6 5 5 5 5 5 5 5 -57 5 5 -6 -6 -6 -6 -6 -6 -6 30 -6 5 5 5 5 -6 5 5 5 -58 5 5 5 -6 -6 5 5 5 5 31 
5 5 5 5 5 5 5 5 5 5 5 5 5 5 5 5 5 5 5 5 -6 5 -6 5 5 -6 5 5 -6 0 0 0 0 5 5 5 5 5 5 5 5 -6 5 5 5 5 5 5 5 5 5 5 -6 -6 -6 -6 -6 -6 -6 -6 5 5 5 5 -6 -6 -6 5 5 5 5 5 -6 -6 -6 -6 -6 -6 -6 5 
5 -6 -6 -6 -6 -6 5 5 5 5 5 5 5 5 5 5 5 5 5 5 -6 5 -6 5 0 5 5 5 5 5 5 5 0 5 5 5 5 5 5 5 5 -6 -6 5 5 5 5 5 5 5 5 -6 -6 -6 5 -6 5 5 5 -6 5 5 -6 5 -6 -6 -6 5 5 5 5 5 -6 -6 5 5 5 5 5 5 
5 -6 5 5 5 -6 5 5 5 5 -6 -6 -6 -6 -6 -6 -6 -6 -6 -6 -6 5 -6 5 0 5 5 5 5 5 5 5 0 5 5 5 5 5 5 5 5 -6 5 5 5 5 5 5 5 5 5 5 -6 5 5 5 5 5 5 5 5 5 5 5 5 -6 5 5 5 5 5 5 5 -6 5 5 5 5 5 5 
5 -6 5 5 5 -6 5 5 5 5 5 5 5 5 5 5 5 5 5 5 5 5 -6 5 0 5 5 5 5 5 5 5 -6 5 5 5 5 5 5 5 5 -6 5 5 5 -6 5 5 5 5 5 5 5 5 5 5 5 5 5 5 5 5 5 5 5 5 5 5 5 5 5 5 5 -6 -6 -6 -6 5 5 5 
5 -6 5 5 5 -6 -6 -6 -6 -6 5 -6 -6 5 -6 -6 -6 -6 -6 -6 -6 -6 -6 5 0 5 5 -6 5 -6 5 5 -6 5 5 5 5 5 5 5 5 -6 -6 5 5 5 5 5 5 5 5 5 5 5 5 -6 -6 5 5 5 -6 -6 5 5 5 5 5 -6 -6 5 5 5 5 5 -6 5 -6 5 5 5 
5 -6 5 5 5 5 5 5 5 -6 5 -6 -6 -6 -6 -6 -6 -6 -6 5 -6 5 5 5 0 5 5 5 5 5 5 5 0 5 5 5 5 5 5 5 5 5 -6 -6 -6 5 5 5 5 5 5 5 5 5 5 -6 -6 5 5 5 -6 -6 5 5 5 5 -6 -6 -6 5 0 5 5 5 5 5 -6 -6 5 5 
5 -6 5 5 5 5 5 5 5 5 5 5 5 5 5 5 5 -6 -6 5 -6 5 5 5 0 5 5 5 5 5 5 5 0 5 5 5 5 5 5 5 5 5 -6 -6 -6 -6 5 5 5 5 5 5 5 5 -6 -6 5 5 5 5 -6 -6 -6 5 0 5 -6 -6 -6 -6 -6 -6 -6 -6 5 5 5 -6 5 5 
5 -6 5 5 5 5 5 5 5 5 5 5 5 5 5 5 5 -6 -6 5 -6 5 5 5 0 0 0 0 -6 5 -6 0 0 5 5 5 5 5 5 5 5 5 5 -6 -6 5 5 5 5 5 5 5 5 5 -6 -6 5 5 5 5 5 -6 5 5 5 5 -6 -6 -6 -6 5 5 -6 -6 5 5 5 -6 -6 5 
5 -6 5 5 5 5 5 5 5 5 5 5 5 5 5 5 5 -6 -6 5 -6 5 5 5 5 5 5 5 -6 5 -6 5 5 5 5 5 5 5 5 5 5 5 5 -6 5 5 5 5 5 5 5 5 5 5 5 5 5 5 5 5 5 5 5 5 5 5 5 -6 -6 -6 -6 -6 -6 5 5 5 5 5 -6 5 
5 -6 5 5 5 5 5 5 5 -59 5 5 5 5 5 5 5 -6 -6 32 -6 5 5 5 5 5 5 5 -6 33 -6 5 5 5 5 5 5 5 5 37 5 5 5 -6 5 5 5 5 5 -61 5 5 5 5 -6 -6 -6 -6 5 34 5 5 5 5 5 5 5 -6 -6 35 5 5 5 5 5 -6 -6 -6 -6 36 
5 -6 5 5 5 5 5 5 -6 5 5 5 5 5 5 5 5 -6 5 5 5 -6 5 5 5 5 5 5 -6 5 5 5 5 5 5 -6 5 5 5 5 5 5 -6 -6 5 5 5 5 -6 -6 5 5 5 5 -6 -6 -6 -6 5 5 5 5 5 5 5 5 5 -6 5 5 5 5 5 5 5 -6 -6 5 5 5 
-6 -6 -6 5 -6 -6 -6 -6 -6 -6 -6 -6 -6 -6 -6 5 5 -6 5 5 5 -6 5 5 5 5 5 5 -6 5 5 5 5 5 5 0 5 5 5 5 5 5 -6 5 5 5 5 5 -6 -6 5 5 5 5 5 -6 -6 -6 -6 -6 -6 5 5 5 5 5 5 5 5 5 5 -6 -6 -6 5 -6 -6 5 5 5 
-6 5 5 5 5 5 5 5 5 5 5 5 5 5 -6 5 5 -6 5 5 5 -6 5 5 5 5 5 5 5 0 0 0 5 5 5 0 5 5 5 5 5 5 -6 5 5 5 5 5 5 5 5 5 5 5 5 5 5 -6 -6 -6 -6 5 5 5 -6 5 5 5 5 5 5 -6 -6 -6 5 5 -6 5 5 5 
-6 5 5 5 5 5 5 5 5 5 5 5 5 5 -6 5 5 -6 -6 -6 -6 -6 -6 -6 -6 -6 -6 -6 -6 -6 -6 -6 5 5 5 0 5 5 5 5 5 5 -6 -6 5 5 5 5 5 5 5 5 5 5 5 5 5 5 5 5 5 5 5 5 5 5 5 5 5 5 5 -6 -6 5 5 -6 -6 5 5 5 
-6 -6 -6 -6 -6 -6 -6 -6 -6 -6 5 5 5 5 -6 5 5 5 5 5 5 5 5 5 5 5 5 5 5 5 5 5 5 5 5 -6 5 5 5 5 5 5 -6 5 5 5 5 5 -6 -6 -6 -6 5 5 5 5 5 5 5 5 5 5 5 5 5 5 -6 -6 -6 -6 5 -6 -6 5 5 -6 -6 5 5 5 
5 5 5 5 5 5 5 5 5 5 5 5 5 5 -6 5 5 5 5 5 5 5 5 5 5 5 5 5 5 5 5 5 5 5 5 -6 5 5 5 5 5 5 -6 5 5 5 5 5 -6 -6 5 -6 5 5 5 5 5 5 5 5 5 5 5 5 5 5 -6 -6 -6 -6 -6 -6 -6 -6 5 5 -6 5 5 5 
5 5 5 5 5 5 5 5 5 5 5 5 5 5 -6 -6 -6 -6 -6 -6 -6 -6 -6 -6 -6 -6 -6 -6 -6 -6 -6 -6 -6 -6 -6 -6 5 5 5 5 5 5 -6 -6 -6 -6 -6 -6 -6 5 5 -6 -6 -6 -6 -6 -6 5 -6 -6 -6 -6 -6 -6 -6 -6 -6 5 5 5 5 5 5 -6 5 -6 -6 5 5 5 
5 5 5 5 5 5 5 5 5 5 5 5 5 5 5 5 5 5 5 5 5 5 5 5 5 5 5 5 5 5 5 5 5 5 5 5 5 5 5 5 5 5 5 5 5 5 5 5 5 5 5 5 5 5 5 5 -6 -6 -6 5 5 5 5 5 5 5 5 5 5 5 5 5 5 -6 -6 -6 5 5 5 5 
5 5 5 5 5 5 5 5 5 5 5 5 5 5 5 5 5 5 5 5 5 5 5 5 5 5 5 5 5 5 5 5 5 5 5 5 5 5 5 5 5 5 5 5 5 5 5 5 5 5 5 5 5 5 5 5 5 5 5 5 5 5 5 5 5 5 5 5 5 5 5 5 5 5 5 5 5 5 5 5 
5 5 5 5 5 5 5 5 5 -62 5 5 5 5 5 5 5 5 5 -63 5 5 5 5 5 5 5 5 5 -64 5 5 5 5 5 5 5 5 5 -65 5 5 5 5 5 5 5 5 5 -66 5 5 5 5 5 5 5 5 5 -67 5 5 5 5 5 5 5 5 5 -68 5 5 5 5 5 5 5 5 5 -69 
5 5 5 5 5 5 5 5 5 5 5 5 5 5 5 5 5 5 5 5 5 5 5 5 5 5 5 5 5 5 5 5 5 5 5 5 5 5 5 5 5 5 5 5 5 5 5 5 5 5 5 5 5 5 5 5 5 5 5 5 5 5 5 5 5 5 5 5 5 5 5 5 5 5 5 5 5 5 5 5 
5 5 5 5 5 5 5 5 5 5 5 5 5 5 5 5 5 5 5 5 5 5 5 5 5 5 5 5 5 5 5 5 5 5 5 5 5 5 5 5 5 5 5 5 5 5 5 5 5 5 5 5 5 5 5 5 5 5 5 5 5 5 5 5 5 5 5 5 5 5 5 5 5 5 5 5 5 5 5 5 
5 5 5 5 5 5 5 5 5 5 5 5 5 5 5 5 5 5 5 5 5 5 5 5 5 5 5 5 5 5 5 5 5 5 5 5 5 5 5 5 5 5 5 5 5 5 5 5 5 5 5 5 5 5 5 5 5 5 5 5 5 5 5 5 5 5 5 5 5 5 5 5 5 5 5 5 5 5 5 5 
5 5 5 5 5 5 5 5 5 5 5 5 5 5 5 5 5 5 5 5 5 5 5 5 5 5 5 5 5 5 5 5 5 5 5 5 5 5 5 5 5 5 5 5 5 5 5 5 5 5 5 5 5 5 5 5 5 5 5 5 5 5 5 5 5 5 5 5 5 5 5 5 5 5 5 5 5 5 5 5 
5 5 5 5 5 5 5 5 5 5 5 5 5 5 5 5 5 5 5 5 5 5 5 5 5 5 5 5 5 5 5 5 5 5 5 5 5 5 5 5 5 5 5 5 5 5 5 5 5 5 5 5 5 5 5 5 5 5 5 5 5 5 5 5 5 5 5 5 5 5 5 5 5 5 5 5 5 5 5 5 
5 5 5 5 5 5 5 5 5 5 5 5 5 5 5 5 5 5 5 5 5 5 5 5 5 5 5 5 5 5 5 5 5 5 5 5 5 5 5 5 5 5 5 5 5 5 5 5 5 5 5 5 5 5 5 5 5 5 5 5 5 5 5 5 5 5 5 5 5 5 5 5 5 5 5 5 5 5 5 5 
5 5 5 5 5 5 5 5 5 5 5 5 5 5 5 5 5 5 5 5 5 5 5 5 5 5 5 5 5 5 5 5 5 5 5 5 5 5 5 5 5 5 5 5 5 5 5 5 5 5 5 5 5 5 5 5 5 5 5 5 5 5 5 5 5 5 5 5 5 5 5 5 5 5 5 5 5 5 5 5 
5 5 5 5 5 5 5 5 5 5 5 5 5 5 5 5 5 5 5 5 5 5 5 5 5 5 5 5 5 5 5 5 5 5 5 5 5 5 5 5 5 5 5 5 5 5 5 5 5 5 5 5 5 5 5 5 5 5 5 5 5 5 5 5 5 5 5 5 5 5 5 5 5 5 5 5 5 5 5 5 
5 5 5 5 5 5 5 5 5 5 5 5 5 5 5 5 5 5 5 5 5 5 5 5 5 5 5 5 5 5 5 5 5 5 5 5 5 5 5 5 5 5 5 5 5 5 5 5 5 5 5 5 5 5 5 5 5 5 5 5 5 5 5 5 5 5 5 5 5 5 5 5 5 5 5 5 5 5 5 5 
5 5 5 5 5 5 5 5 5 5 5 5 5 5 5 5 5 5 5 5 5 5 5 5 5 5 5 5 5 5 5 5 5 5 5 5 5 5 5 5 5 5 5 5 5 5 5 5 5 5 5 5 5 5 5 5 5 5 5 5 5 5 5 5 5 5 5 5 5 5 5 5 5 5 5 5 5 5 5 5 
5 5 5 5 5 5 5 5 5 5 5 5 5 5 5 5 5 5 5 5 5 5 5 5 5 5 5 5 5 5 5 5 5 5 5 5 5 5 5 5 5 5 5 5 5 5 5 5 5 5 5 5 5 5 5 5 5 5 5 5 5 5 5 5 5 5 5 5 5 5 5 5 5 5 5 5 5 5 5 5 
5 5 5 5 5 5 5 5 5 5 5 5 5 5 5 5 5 5 5 5 5 5 5 5 5 5 5 5 5 5 5 5 5 5 5 5 5 5 5 5 5 5 5 5 5 5 5 5 5 5 5 5 5 5 5 5 5 5 5 5 5 5 5 5 5 5 5 5 5 5 5 5 5 5 5 5 5 5 5 5 
5 5 5 5 5 5 5 5 5 5 5 5 5 5 5 5 5 5 5 5 5 5 5 5 5 5 5 5 5 5 5 5 5 5 5 5 5 5 5 5 5 5 5 5 5 5 5 5 5 5 5 5 5 5 5 5 5 5 5 5 5 5 5 5 5 5 5 5 5 5 5 5 5 5 5 5 5 5 5 5 
5 5 5 5 5 5 5 5 5 5 5 5 5 5 5 5 5 5 5 5 5 5 5 5 5 5 5 5 5 5 5 5 5 5 5 5 5 5 5 5 5 5 5 5 5 5 5 5 5 5 5 5 5 5 5 5 5 5 5 5 5 5 5 5 5 5 5 5 5 5 5 5 5 5 5 5 5 5 5 5 
5 5 5 5 5 5 5 5 5 5 5 5 5 5 5 5 5 5 5 5 5 5 5 5 5 5 5 5 5 5 5 5 5 5 5 5 5 5 5 5 5 5 5 5 5 5 5 5 5 5 5 5 5 5 5 5 5 5 5 5 5 5 5 5 5 5 5 5 5 5 5 5 5 5 5 5 5 5 5 5 
5 5 5 5 5 5 5 5 5 5 5 5 5 5 5 5 5 5 5 5 5 5 5 5 5 5 5 5 5 5 5 5 5 5 5 5 5 5 5 5 5 5 5 5 5 5 5 5 5 5 5 5 5 5 5 5 5 5 5 5 5 5 5 5 5 5 5 5 5 5 5 5 5 5 5 5 5 5 5 5 
5 5 5 5 5 5 5 5 5 5 5 5 5 5 5 5 5 5 5 5 5 5 5 5 5 5 5 5 5 5 5 5 5 5 5 5 5 5 5 5 5 5 5 5 5 5 5 5 5 5 5 5 5 5 5 5 5 5 5 5 5 5 5 5 5 5 5 5 5 5 5 5 5 5 5 5 5 5 5 5 
5 5 5 5 5 5 5 5 5 5 5 5 5 5 5 5 5 5 5 5 5 5 5 5 5 5 5 5 5 5 5 5 5 5 5 5 5 5 5 5 5 5 5 5 5 5 5 5 5 5 5 5 5 5 5 5 5 5 5 5 5 5 5 5 5 5 5 5 5 5 5 5 5 5 5 5 5 5 5 5 
5 5 5 5 5 5 5 5 5 5 5 5 5 5 5 5 5 5 5 5 5 5 5 5 5 5 5 5 5 5 5 5 5 5 5 5 5 5 5 5 5 5 5 5 5 5 5 5 5 5 5 5 5 5 5 5 5 5 5 5 5 5 5 5 5 5 5 5 5 5 5 5 5 5 5 5 5 5 5 5 
5 5 5 5 5 5 5 5 5 5 5 5 5 5 5 5 5 5 5 5 5 5 5 5 5 5 5 5 5 5 5 5 5 5 5 5 5 5 5 5 5 5 5 5 5 5 5 5 5 5 5 5 5 5 5 5 5 5 5 5 5 5 5 5 5 5 5 5 5 5 5 5 5 5 5 5 5 5 5 5 
5 5 5 5 5 5 5 5 5 5 5 5 5 5 5 5 5 5 5 5 5 5 5 5 5 5 5 5 5 5 5 5 5 5 5 5 5 5 5 5 5 5 5 5 5 5 5 5 5 5 5 5 5 5 5 5 5 5 5 5 5 5 5 5 5 5 5 5 5 5 5 5 5 5 5 5 5 5 5 5 
5 5 5 5 5 5 5 5 5 5 5 5 5 5 5 5 5 5 5 5 5 5 5 5 5 5 5 5 5 5 5 5 5 5 5 5 5 5 5 5 5 5 5 5 5 5 5 5 5 5 5 5 5 5 5 5 5 5 5 5 5 5 5 5 5 5 5 5 5 5 5 5 5 5 5 5 5 5 5 5 
5 5 5 5 5 5 5 5 5 5 5 5 5 5 5 5 5 5 5 5 5 5 5 5 5 5 5 5 5 5 5 5 5 5 5 5 5 5 5 5 5 5 5 5 5 5 5 5 5 5 5 5 5 5 5 5 5 5 5 5 5 5 5 5 5 5 5 5 5 5 5 5 5 5 5 5 5 5 5 5 
5 5 5 5 5 5 5 5 5 5 5 5 5 5 5 5 5 5 5 5 5 5 5 5 5 5 5 5 5 5 5 5 5 5 5 5 5 5 5 5 5 5 5 5 5 5 5 5 5 5 5 5 5 5 5 5 5 5 5 5 5 5 5 5 5 5 5 5 5 5 5 5 5 5 5 5 5 5 5 5 
5 5 5 5 5 5 5 5 5 5 5 5 5 5 5 5 5 5 5 5 5 5 5 5 5 5 5 5 5 5 5 5 5 5 5 5 5 5 5 5 5 5 5 5 5 5 5 5 5 5 5 5 5 5 5 5 5 5 5 5 5 5 5 5 5 5 5 5 5 5 5 5 5 5 5 5 5 5 5 5 
5 5 5 5 5 5 5 5 5 5 5 5 5 5 5 5 5 5 5 5 5 5 5 5 5 5 5 5 5 5 5 5 5 5 5 5 5 5 5 5 5 5 5 5 5 5 5 5 5 5 5 5 5 5 5 5 5 5 5 5 5 5 5 5 5 5 5 5 5 5 5 5 5 5 5 5 5 5 5 5 
5 5 5 5 5 5 5 5 5 5 5 5 5 5 5 5 5 5 5 5 5 5 5 5 5 5 5 5 5 5 5 5 5 5 5 5 5 5 5 5 5 5 5 5 5 5 5 5 5 5 5 5 5 5 5 5 5 5 5 5 5 5 5 5 5 5 5 5 5 5 5 5 5 5 5 5 5 5 5 5 
5 5 5 5 5 5 5 5 5 5 5 5 5 5 5 5 5 5 5 5 5 5 5 5 5 5 5 5 5 5 5 5 5 5 5 5 5 5 5 5 5 5 5 5 5 5 5 5 5 5 5 5 5 5 5 5 5 5 5 5 5 5 5 5 5 5 5 5 5 5 5 5 5 5 5 5 5 5 5 5 
5 5 5 5 5 5 5 5 5 5 5 5 5 5 5 5 5 5 5 5 5 5 5 5 5 5 5 5 5 5 5 5 5 5 5 5 5 5 5 5 5 5 5 5 5 5 5 5 5 5 5 5 5 5 5 5 5 5 5 5 5 5 5 5 5 5 5 5 5 5 5 5 5 5 5 5 5 5 5 5 
5 5 5 5 5 5 5 5 5 5 5 5 5 5 5 5 5 5 5 5 5 5 5 5 5 5 5 5 5 5 5 5 5 5 5 5 5 5 5 5 5 5 5 5 5 5 5 5 5 5 5 5 5 5 5 5 5 5 5 5 5 5 5 5 5 5 5 5 5 5 5 5 5 5 5 5 5 5 5 5 
5 5 5 5 5 5 5 5 5 5 5 5 5 5 5 5 5 5 5 5 5 5 5 5 5 5 5 5 5 5 5 5 5 5 5 5 5 5 5 5 5 5 5 5 5 5 5 5 5 5 5 5 5 5 5 5 5 5 5 5 5 5 5 5 5 5 5 5 5 5 5 5 5 5 5 5 5 5 5 5 
5 5 5 5 5 5 5 5 5 5 5 5 5 5 5 5 5 5 5 5 5 5 5 5 5 5 5 5 5 5 5 5 5 5 5 5 5 5 5 5 5 5 5 5 5 5 5 5 5 5 5 5 5 5 5 5 5 5 5 5 5 5 5 5 5 5 5 5 5 5 5 5 5 5 5 5 5 5 5 5 
5 5 5 5 5 5 5 5 5 5 5 5 5 5 5 5 5 5 5 5 5 5 5 5 5 5 5 5 5 5 5 5 5 5 5 5 5 5 5 5 5 5 5 5 5 5 5 5 5 5 5 5 5 5 5 5 5 5 5 5 5 5 5 5 5 5 5 5 5 5 5 5 5 5 5 5 5 5 5 5 
5 5 5 5 5 5 5 5 5 5 5 5 5 5 5 5 5 5 5 5 5 5 5 5 5 5 5 5 5 5 5 5 5 5 5 5 5 5 5 5 5 5 5 5 5 5 5 5 5 5 5 5 5 5 5 5 5 5 5 5 5 5 5 5 5 5 5 5 5 5 5 5 5 5 5 5 5 5 5 5 
5 5 5 5 5 5 5 5 5 5 5 5 5 5 5 5 5 5 5 5 5 5 5 5 5 5 5 5 5 5 5 5 5 5 5 5 5 5 5 5 5 5 5 5 5 5 5 5 5 5 5 5 5 5 5 5 5 5 5 5 5 5 5 5 5 5 5 5 5 5 5 5 5 5 5 5 5 5 5 5 
5 5 5 5 5 5 5 5 5 5 5 5 5 5 5 5 5 5 5 5 5 5 5 5 5 5 5 5 5 5 5 5 5 5 5 5 5 5 5 5 5 5 5 5 5 5 5 5 5 5 5 5 5 5 5 5 5 5 5 5 5 5 5 5 5 5 5 5 5 5 5 5 5 5 5 5 5 5 5 5 
5 5 5 5 5 5 5 5 5 5 5 5 5 5 5 5 5 5 5 5 5 5 5 5 5 5 5 5 5 5 5 5 5 5 5 5 5 5 5 5 5 5 5 5 5 5 5 5 5 5 5 5 5 5 5 5 5 5 5 5 5 5 5 5 5 5 5 5 5 5 5 5 5 5 5 5 5 5 5 5 
5 5 5 5 5 5 5 5 5 5 5 5 5 5 5 5 5 5 5 5 5 5 5 5 5 5 5 5 5 5 5 5 5 5 5 5 5 5 5 5 5 5 5 5 5 5 5 5 5 5 5 5 5 5 5 5 5 5 5 5 5 5 5 5 5 5 5 5 5 5 5 5 5 5 5 5 5 5 5 5 
5 5 5 5 5 5 5 5 5 5 5 5 5 5 5 5 5 5 5 5 5 5 5 5 5 5 5 5 5 5 5 5 5 5 5 5 5 5 5 5 5 5 5 5 5 5 5 5 5 5 5 5 5 5 5 5 5 5 5 5 5 5 5 5 5 5 5 5 5 5 5 5 5 5 5 5 5 5 5 5 
5 5 5 5 5 5 5 5 5 5 5 5 5 5 5 5 5 5 5 5 5 5 5 5 5 5 5 5 5 5 5 5 5 5 5 5 5 5 5 5 5 5 5 5 5 5 5 5 5 5 5 5 5 5 5 5 5 5 5 5 5 5 5 5 5 5 5 5 5 5 5 5 5 5 5 5 5 5 5 5 
