-6 -6 -6 -6 -6 -6 -6 -6 -6 -6 -6 -6 -6 -6 -6 -6 -6 -6 -6 -6 -6 -26 -20 -20 -20 -20 -20 -20 -20 -20 -20 -20 -20 -20 -20 -20 -20 -20 4 -28 
-6 -2 -6 -2 -6 -2 -6 -2 -6 -2 -6 -2 -6 -2 -6 -2 -6 -2 -6 -2 -6 -26 -20 -20 -20 -20 -20 -20 -20 -20 -20 -20 -20 -20 -20 -20 -20 -20 4 -28 
-6 -6 5 5 5 5 5 5 5 5 5 18 22 22 22 22 22 22 16 5 4 4 4 4 4 4 4 4 4 4 4 4 4 4 4 4 4 4 4 4 
-6 -2 5 5 5 5 5 5 5 5 5 20 10 4 4 4 4 10 21 5 4 -21 -25 -25 -25 -25 -25 -25 -25 -25 -25 -25 -25 -25 -25 -25 -25 -25 4 -22 
-6 -6 5 5 5 5 5 5 5 5 5 20 10 4 -17 4 -18 10 21 5 5 5 5 5 5 5 5 5 5 5 5 5 5 5 5 5 5 5 -6 -6 
-6 -2 5 5 5 5 5 5 5 5 5 20 10 4 -14 4 -13 10 21 5 5 5 5 5 5 5 5 5 5 5 5 5 5 5 5 5 5 5 -6 -2 
-6 -6 5 5 5 5 5 5 5 5 5 20 10 4 -14 4 -13 10 21 5 5 5 5 5 5 5 5 5 5 5 5 5 5 5 5 5 5 5 -6 -6 
-6 -2 5 5 5 5 5 5 5 5 5 20 10 4 -14 22 -13 10 21 5 5 5 5 5 5 5 5 5 5 5 5 5 5 5 5 5 5 5 -6 -2 
-6 -6 5 5 5 5 5 5 5 5 5 20 10 4 -14 22 -13 10 21 5 5 5 5 5 5 5 5 5 5 5 -6 -6 4 4 5 5 5 5 -6 -6 
-6 -2 5 5 5 5 5 5 5 5 5 20 10 4 -14 4 -13 10 21 5 5 5 5 5 5 5 5 5 5 5 -6 -23 4 -24 5 5 5 5 -6 -2 
-6 -6 5 5 5 5 5 5 4 4 4 4 10 4 -14 4 -13 10 21 5 4 4 4 4 4 4 4 4 4 4 -6 -26 4 -28 5 5 5 5 -6 -6 
-6 -2 5 5 5 5 5 5 4 -17 4 -18 10 4 4 4 4 10 21 5 4 -17 -12 -12 -12 -12 -12 -12 4 -18 -6 -26 4 -28 5 5 5 5 -6 -2 
-6 -6 5 5 5 5 5 5 4 -14 4 -13 10 4 -16 4 -19 10 21 5 4 -14 18 22 22 22 22 16 4 -13 -6 -26 4 -28 5 5 5 5 -6 -6 
-6 -2 5 5 5 5 5 5 4 -14 4 -13 10 10 10 10 10 10 21 5 4 -14 20 10 10 10 10 21 4 -13 -6 -26 4 -28 5 5 5 5 -6 -2 
-6 -6 5 5 5 5 5 5 4 -14 4 -13 10 17 19 19 19 19 12 5 4 -14 20 10 10 10 10 21 4 -13 -6 -26 4 -28 5 5 5 5 -6 -6 
-6 -2 5 5 5 5 5 5 4 -14 4 -13 10 21 5 5 5 5 5 5 4 -14 20 10 10 10 10 21 4 -13 4 4 4 4 5 5 5 5 -6 -2 
-6 -6 5 5 5 5 5 5 4 4 0 -13 10 13 22 22 22 22 22 22 4 -14 20 10 10 10 10 21 4 -13 4 -21 4 -22 5 5 5 5 -6 -6 
-6 -2 5 5 5 5 5 5 4 -16 0 -19 10 10 10 10 10 10 10 10 4 -14 14 19 19 19 19 12 4 -13 5 5 5 5 5 5 5 5 -6 -2 
-6 -6 5 5 5 5 5 5 10 10 4 4 4 4 4 4 4 4 4 4 4 4 4 -6 5 -6 4 4 4 4 5 5 5 5 5 5 5 5 -6 -6 
-6 -2 5 5 5 5 5 5 10 10 4 -17 -12 -12 -12 -12 -12 -12 4 -18 4 -16 -15 -6 5 8 -15 -15 4 -19 5 5 5 5 5 5 5 5 -6 -2 
-6 -6 5 5 5 5 5 5 5 5 0 0 0 0 0 0 0 0 0 0 5 5 5 5 5 5 5 5 0 -14 4 4 21 5 5 5 5 5 -6 -6 
-6 -2 5 5 5 5 5 5 5 5 -15 -16 -15 -15 -15 -15 -15 -15 -15 -19 5 5 5 5 5 5 5 5 0 -17 4 -18 21 5 5 5 5 5 -6 -2 
-6 -6 5 5 5 5 5 5 5 5 5 5 5 5 5 5 5 5 5 5 5 5 5 5 5 5 5 5 0 -14 4 -13 21 5 5 5 5 5 -6 -6 
-6 -2 5 5 5 5 5 5 5 5 5 5 5 5 5 5 5 5 5 5 5 5 5 5 5 5 5 5 0 -14 4 -13 21 5 5 5 5 5 -6 -2 
-6 -6 5 5 5 5 5 5 5 5 5 5 5 5 5 5 5 5 5 5 5 5 5 5 5 5 5 5 0 -14 4 -13 21 5 5 5 5 5 -6 -6 
-6 -2 5 5 5 5 5 5 5 5 5 5 5 5 5 5 5 5 5 5 5 5 5 5 5 5 5 5 0 -14 4 -13 21 5 5 5 5 5 -6 -2 
-6 -6 5 5 5 5 5 5 5 5 5 5 5 5 5 5 5 5 5 5 5 5 5 5 5 5 5 5 0 -14 4 -13 21 5 5 5 5 5 -6 -6 
-6 -2 5 5 5 5 5 5 5 5 5 5 5 5 5 5 5 5 5 5 5 5 5 5 5 5 5 5 0 -14 4 -13 21 5 5 5 5 5 -6 -2 
-6 -6 5 5 5 5 5 5 5 5 5 5 5 5 5 5 5 5 5 5 5 5 5 5 5 5 5 5 0 0 4 4 21 5 5 5 5 5 -6 -6 
-6 -2 5 5 5 5 5 5 5 5 5 5 5 5 5 5 5 5 5 5 5 5 5 5 5 5 5 5 5 -16 4 -19 21 5 5 5 5 5 -6 -2 
-6 -6 4 4 4 4 4 4 4 4 4 4 4 4 4 4 4 4 4 4 4 4 4 4 4 4 4 4 4 4 4 4 4 -6 5 -6 4 4 -6 -6 
-6 -2 4 -16 -15 -15 -15 -15 -15 -15 -15 -15 -15 -15 -15 -15 -15 -15 -15 -15 -15 -15 -15 -15 -15 -15 -15 -15 -15 -15 -15 -15 -15 -6 5 8 4 -19 -6 -2 
-6 -6 20 17 19 19 19 19 19 19 19 19 19 19 19 19 19 19 19 19 19 19 19 19 19 19 19 19 19 19 19 19 12 5 5 5 14 12 -6 -6 
-6 -2 14 12 5 5 5 5 5 5 5 5 5 5 5 5 5 5 5 5 5 5 5 18 22 22 22 16 5 5 5 5 5 5 5 5 5 5 -6 -2 
-6 -6 5 5 5 5 5 5 5 5 5 5 5 5 5 18 22 22 16 5 5 5 5 20 17 19 15 21 5 18 22 22 16 18 22 16 5 5 -6 -6 
-6 -2 5 5 5 5 5 5 5 5 22 22 22 22 22 11 10 10 21 5 5 5 5 20 21 5 20 21 5 20 10 10 21 20 10 21 5 5 -6 -2 
-6 -6 5 5 5 5 5 5 5 5 10 10 10 10 10 10 10 10 13 22 22 22 22 11 21 5 20 13 22 11 10 10 13 11 10 21 5 5 -6 -6 
-6 -2 5 5 5 5 5 5 5 5 19 19 19 19 19 19 19 19 19 19 19 19 19 19 12 5 14 19 19 19 19 19 19 19 19 12 5 5 -6 -2 
-6 -6 -6 -6 -6 -6 -6 -6 -6 -6 -6 -6 -6 -6 -6 -6 -6 -6 -6 -6 -6 -6 -6 -6 -6 -6 -6 -6 -6 -6 -6 -6 -6 -6 -6 -6 -6 -6 -6 -6 
-6 -2 -6 -2 -6 -2 -6 -2 -6 -2 -6 -2 -6 -2 -6 -2 -6 -2 -6 -2 -6 -2 -6 -2 -6 -2 -6 -2 -6 -2 -6 -2 -6 -2 -6 -2 -6 -2 -6 -2 
