5 5 -6 -6 -6 -6 -6 -6 5 5 5 5 5 5 5 5 5 5 5 5 5 5 5 5 5 5 5 5 5 5 5 5 5 5 5 5 5 5 5 5 
5 -6 -6 5 5 5 5 -6 5 5 5 5 5 5 5 5 5 5 5 5 5 5 5 5 -6 -6 -6 -6 -6 -6 -6 -6 -6 -6 -6 5 5 5 5 5 
5 -6 -6 5 5 5 5 -6 5 5 5 -6 -6 -6 -6 -6 -6 -6 -6 -6 -6 -6 5 5 -6 5 5 5 5 5 5 5 5 5 -6 5 5 5 5 5 
5 5 -6 5 5 5 5 -6 5 5 5 -6 5 5 5 5 5 5 5 5 5 -6 5 -6 -6 5 5 5 5 5 5 5 5 5 -6 5 -6 -6 5 5 
5 5 -6 5 5 5 5 -6 5 5 5 -6 5 5 5 5 5 5 5 5 5 -6 5 -6 5 5 5 5 -6 5 -6 5 5 5 -6 -6 -6 -6 -6 5 
5 5 -6 5 5 5 5 -6 5 5 5 -6 5 5 5 5 5 -6 5 5 5 -6 5 -6 5 5 5 5 5 5 5 5 5 5 5 5 5 5 -6 5 
5 5 -6 5 5 5 5 -6 5 5 5 -6 -6 -6 -6 -6 -6 -6 -6 -6 -6 -6 5 -6 -6 5 5 5 5 5 5 5 5 5 5 5 5 5 -6 5 
5 5 -6 5 5 5 5 -6 5 5 5 5 5 5 5 5 5 5 5 5 5 5 5 5 -6 -6 5 5 5 5 5 5 5 5 5 5 5 5 -6 5 
5 5 -6 5 5 5 5 -6 5 5 -6 -6 -6 5 5 5 5 5 5 5 5 5 5 5 -6 5 5 5 5 5 5 5 -6 -6 -6 -6 -6 -6 -6 5 
5 5 -6 -6 -6 5 5 -6 -6 -70 5 5 -6 5 5 5 5 5 5 -71 5 5 5 5 -6 5 5 5 5 39 5 -6 5 5 5 5 5 5 5 -72 
5 5 5 -6 5 -6 5 5 5 5 5 5 -6 5 -6 -6 5 5 -6 -6 -6 5 -6 -6 -6 -6 5 5 5 -6 5 5 5 5 5 5 5 5 5 5 
5 5 5 -6 5 5 -6 -6 -6 5 5 5 5 5 -6 -6 5 5 -6 5 5 -6 5 5 5 -6 5 5 5 -6 5 5 5 5 5 -6 -6 -6 5 5 
5 5 5 -6 5 5 5 5 -6 5 5 5 5 5 -6 5 5 5 -6 5 5 5 5 5 5 -6 5 5 -6 -6 5 5 5 5 -6 -6 5 -6 5 5 
5 5 -6 -6 -6 5 -6 5 -6 5 5 -6 -6 -6 -6 5 5 -6 5 5 5 5 5 -6 5 -6 5 -6 -6 5 5 5 5 5 -6 5 5 -6 5 5 
5 5 5 5 5 -6 5 5 5 -6 -6 5 5 5 5 5 5 -6 5 5 5 5 5 -6 -6 5 -6 5 5 5 5 5 5 -6 -6 5 5 -6 5 5 
5 5 5 5 5 5 5 5 5 5 5 5 5 5 5 5 -6 5 -6 -6 -6 5 5 -6 5 5 5 5 5 5 5 -6 -6 -6 5 5 5 -6 5 5 
5 5 5 5 5 -6 5 5 5 -6 -6 5 5 5 5 5 -6 5 5 5 5 5 5 -6 5 5 5 5 5 5 -6 -6 5 5 5 -6 -6 -6 5 5 
5 5 5 -6 -6 5 -6 -6 -6 5 -6 -6 5 5 5 5 -6 5 5 5 5 -6 -6 -6 -6 5 -6 5 5 5 -6 5 5 5 -6 -6 5 5 5 5 
5 5 5 -6 5 5 5 5 5 5 5 5 -6 5 5 5 5 -6 5 5 5 -6 -6 -6 5 -6 5 -6 -6 -6 -6 5 5 5 -6 5 5 5 5 5 
5 5 5 -6 5 5 5 5 5 40 5 5 -6 5 5 5 5 -6 5 41 5 -6 5 5 5 5 5 5 5 42 5 5 5 -6 -6 5 5 5 5 -73 
5 5 -6 5 5 5 5 5 5 5 5 5 -6 -6 -6 -6 -6 -6 -6 -6 -6 -6 -6 -6 5 5 5 5 5 5 5 5 5 -6 5 5 5 5 5 5 
5 5 -6 -6 5 5 5 5 5 5 5 -6 -6 5 5 5 5 -6 5 -6 -6 -6 -6 -6 5 5 5 5 5 5 5 5 -6 -6 5 5 5 5 5 5 
5 5 5 -6 5 5 5 5 5 5 5 -6 5 5 5 5 -6 -6 5 5 5 5 5 5 5 -6 -6 -6 5 5 5 5 -6 5 5 5 5 5 5 5 
5 5 -6 -6 5 5 5 5 5 5 5 -6 -6 5 5 5 -6 5 5 5 5 5 5 5 5 -6 -6 -6 5 5 5 5 -6 5 5 5 5 5 5 5 
5 5 -6 5 5 5 5 5 5 5 5 5 -6 -6 -6 5 -6 5 5 5 -6 -6 5 5 5 5 -6 5 5 5 5 5 -6 5 5 5 5 5 5 5 
5 5 -6 -6 5 5 5 5 5 5 5 5 5 5 -6 5 5 -6 -6 -6 5 -6 5 5 5 5 5 5 5 5 5 5 -6 5 5 5 5 5 5 5 
5 5 5 -6 -6 -6 -6 5 5 5 5 5 5 5 -6 5 5 5 5 5 5 5 -6 -6 -6 5 5 -6 -6 -6 5 5 -6 -6 -6 -6 -6 5 5 5 
5 5 5 -6 -6 -6 -6 -6 5 -6 5 -6 5 -6 -6 5 5 5 -6 -6 5 5 5 -6 5 5 5 -6 5 -6 5 5 5 5 5 5 -6 -6 5 5 
5 5 5 5 5 5 5 -6 -6 -6 -6 -6 -6 -6 5 5 5 -6 -6 5 5 5 5 -6 5 5 -6 -6 5 -6 -6 -6 -6 -6 5 5 5 -6 5 5 
5 5 5 5 5 5 5 -6 5 -74 5 -6 5 5 5 5 -6 5 5 43 5 5 5 -6 5 5 -6 5 5 -75 5 5 5 -6 -6 5 5 -6 5 -76 
5 5 5 5 -6 -6 -6 5 5 5 5 -6 5 5 -6 -6 5 5 5 5 5 -6 5 -6 -6 5 -6 5 5 5 -6 -6 -6 -6 -6 5 5 -6 5 5 
5 5 5 5 -6 5 5 5 5 5 5 -6 5 5 -6 5 5 5 5 5 5 -6 -6 -6 5 5 -6 -6 5 5 -6 5 5 5 5 5 -6 -6 5 5 
5 5 5 5 -6 5 5 5 -6 -6 -6 -6 -6 5 -6 5 5 5 5 5 -6 -6 5 5 5 5 5 -6 -6 -6 5 5 -6 -6 5 5 -6 -6 5 5 
5 5 5 5 -6 5 5 -6 -6 5 5 -6 5 -6 -6 -6 5 -6 -6 -6 5 -6 5 5 5 5 5 5 5 5 5 5 -6 -6 -6 5 5 -6 5 5 
5 5 5 -6 -6 5 5 -6 -6 -6 -6 5 5 5 -6 -6 -6 -6 5 5 5 -6 5 5 5 5 5 5 5 5 5 -6 -6 -6 5 5 5 -6 5 5 
5 5 -6 -6 5 5 5 5 5 5 5 5 5 5 5 5 -6 5 5 5 5 -6 5 5 5 5 5 5 -6 -6 -6 -6 5 -6 5 5 -6 -6 5 5 
5 5 -6 5 5 5 5 -6 -6 -6 -6 -6 5 5 5 5 -6 5 5 5 5 -6 5 5 5 5 -6 -6 -6 5 5 5 5 -6 5 5 -6 -6 5 5 
5 5 -6 5 5 5 5 -6 5 5 5 5 -6 -6 5 5 -6 5 5 5 5 -6 -6 5 5 5 -6 5 5 5 5 5 5 -6 -6 5 5 -6 5 5 
5 5 -6 5 5 -6 -6 -6 5 5 5 5 5 -6 5 5 -6 5 5 5 5 5 -6 -6 -6 -6 -6 5 5 5 5 5 5 5 -6 5 5 -6 5 5 
5 5 -6 -6 -6 -6 5 5 5 -77 5 5 5 -6 -6 -6 5 5 5 -78 5 5 5 5 5 5 5 5 5 -79 5 5 5 5 -6 -6 -6 -6 5 -80 
