5 5 5 5 5 5 5 5 5 5 5 5 5 5 5 5 5 5 5 5 5 5 5 5 5 5 5 5 5 5 5 5 5 5 5 5 5 5 5 5 
5 5 5 5 5 5 5 5 5 5 5 5 5 5 5 5 5 5 5 5 5 5 5 5 5 5 5 5 5 5 5 5 5 5 5 5 5 5 5 5 
5 5 5 5 5 5 5 5 5 5 5 5 5 5 5 5 5 5 5 5 5 5 5 5 5 5 5 5 5 5 5 5 5 5 5 5 5 5 5 5 
5 5 5 5 5 5 5 5 5 5 5 -6 5 5 5 5 5 5 5 5 5 5 5 5 5 5 5 5 5 5 -6 -6 -6 -6 -6 -6 -6 5 5 5 
5 5 5 5 5 -6 -6 -6 -6 -6 -6 5 -6 -6 5 5 5 5 5 5 5 5 5 5 5 5 5 5 5 -6 5 5 -6 -6 5 5 -6 5 5 5 
5 5 5 5 5 -6 5 5 5 5 5 5 5 -6 5 -6 -6 -6 -6 -6 -6 -6 -6 -6 -6 5 5 5 5 -6 5 5 5 5 5 5 -6 5 5 5 
5 5 5 5 5 -6 5 5 5 5 5 5 5 -6 5 -6 5 5 5 5 5 5 5 5 -6 5 5 5 5 -6 5 5 5 5 5 5 -6 5 5 5 
5 5 5 5 5 -6 5 5 -6 5 5 5 5 -6 5 -6 5 5 5 5 5 5 5 5 -6 5 5 5 5 -6 5 5 5 5 5 5 -6 5 5 5 
5 5 5 5 5 -6 5 5 5 5 5 5 5 -6 5 -6 5 5 5 5 5 5 5 5 -6 5 5 5 5 -6 5 5 5 5 5 5 -6 5 5 5 
5 5 5 5 5 -6 5 5 5 45 5 5 5 -6 5 -6 5 5 5 -82 5 5 5 5 -6 5 5 5 5 -83 -6 -6 -6 5 -6 -6 -6 5 5 -84 
5 5 5 5 5 -6 5 5 5 5 5 5 5 -6 5 5 -6 5 5 5 5 5 5 5 -6 5 5 5 5 5 5 5 5 -6 5 5 5 5 5 5 
5 5 5 5 5 -6 5 5 5 5 5 5 5 -6 5 5 -6 5 5 5 5 5 5 5 -6 5 5 5 5 5 5 5 5 5 5 5 5 5 5 5 
5 5 5 5 5 -6 5 5 5 5 5 5 5 -6 5 5 -6 5 5 -6 -6 -6 5 5 -6 5 5 5 5 5 5 5 5 5 5 5 5 5 5 5 
5 5 5 5 5 -6 5 -6 5 5 5 5 5 -6 5 5 -6 -6 -6 -6 5 5 -6 -6 -6 5 5 5 5 5 5 5 5 5 5 5 5 5 5 5 
5 5 5 5 5 -6 5 5 5 5 5 5 5 -6 5 5 5 5 5 5 5 5 5 5 5 5 5 5 5 5 5 5 5 5 5 5 5 5 5 5 
5 5 5 5 5 -6 -6 -6 -6 5 -6 -6 -6 -6 5 5 5 5 5 5 5 5 5 5 -6 -6 -6 -6 -6 -6 -6 -6 -6 -6 -6 -6 5 5 5 5 
5 5 5 5 5 5 5 5 -6 -6 5 5 5 5 5 5 5 5 5 5 5 5 5 5 -6 5 5 5 5 5 5 5 5 5 -6 -6 5 5 5 5 
5 5 5 5 5 5 5 5 5 5 5 5 5 5 5 5 5 5 5 5 5 5 5 5 -6 5 5 5 5 5 5 5 5 5 5 -6 5 5 5 5 
5 5 5 5 5 5 5 5 5 5 5 5 5 5 5 5 5 5 5 5 5 5 5 5 -6 5 5 5 5 5 5 5 5 5 5 -6 5 5 5 5 
5 5 5 5 5 5 5 5 5 -85 5 5 5 5 5 5 5 5 5 -86 5 5 5 5 -6 5 5 5 5 46 5 5 5 5 5 -6 5 5 5 -87 
5 5 5 5 5 5 5 5 5 5 5 5 5 5 5 5 5 5 5 5 5 5 5 5 -6 5 5 5 5 5 5 5 5 5 5 -6 5 5 5 5 
5 5 5 5 5 5 5 5 5 5 5 5 5 5 5 5 5 5 5 5 5 5 5 5 -6 5 5 5 5 5 5 5 5 5 5 -6 5 5 5 5 
5 5 5 5 5 -6 -6 -6 -6 -6 -6 -6 -6 -6 -6 -6 -6 5 5 5 5 5 5 5 -6 5 5 5 5 5 5 -6 5 5 5 -6 5 5 5 5 
5 5 5 5 5 -6 5 5 5 5 5 5 5 5 5 5 -6 -6 -6 -6 -6 -6 -6 -6 -6 5 5 5 5 5 5 5 5 5 5 -6 5 5 5 5 
5 5 5 5 5 -6 5 5 5 5 5 5 5 5 5 5 5 5 5 5 5 5 5 5 5 5 5 5 5 5 5 5 5 5 5 -6 5 5 5 5 
5 5 5 5 5 -6 5 5 5 5 5 5 5 5 5 5 -6 -6 -6 -6 -6 -6 -6 -6 -6 -6 5 5 5 5 5 5 5 5 5 -6 5 5 5 5 
5 5 5 5 5 -6 5 5 5 5 5 5 5 5 5 5 -6 5 5 5 5 5 5 5 5 -6 -6 -6 5 -6 -6 -6 -6 -6 -6 -6 5 5 5 5 
5 5 5 5 5 -6 5 5 5 5 5 5 5 5 5 5 -6 5 5 5 5 5 5 5 5 5 5 -6 -6 -6 5 5 5 5 5 5 5 5 5 5 
5 5 5 5 5 -6 5 5 5 5 5 5 5 5 5 5 -6 5 5 5 5 5 5 5 5 5 5 5 5 5 5 5 5 5 5 5 5 5 5 5 
5 5 5 5 5 -6 5 5 5 -88 5 5 5 5 5 5 -6 5 5 -89 5 5 5 5 5 5 5 5 5 -90 5 5 5 5 5 5 5 5 5 -91 
5 5 5 5 5 -6 5 5 5 5 5 5 5 5 5 5 -6 5 5 5 5 5 5 5 5 -6 -6 -6 -6 -6 -6 -6 -6 5 5 5 5 5 5 5 
5 5 5 5 5 -6 5 5 5 5 5 5 5 5 5 5 -6 5 5 5 5 5 5 5 5 -6 5 5 5 5 5 5 -6 5 5 5 5 5 5 5 
5 5 5 5 5 -6 5 5 5 5 5 5 5 5 5 5 -6 5 5 5 5 5 5 5 5 -6 5 5 5 5 5 5 -6 5 5 5 5 5 5 5 
5 5 5 5 5 -6 5 5 -6 5 -6 5 5 5 5 -6 -6 5 5 5 5 5 5 5 5 -6 5 5 -6 -6 5 5 -6 -6 5 5 5 5 5 5 
5 5 5 5 5 -6 -6 -6 -6 -6 -6 -6 -6 -6 -6 -6 5 5 5 5 5 5 5 5 5 -6 -6 -6 -6 -6 -6 -6 -6 5 5 5 5 5 5 5 
5 5 5 5 5 5 5 5 5 5 5 5 5 5 5 5 5 5 5 5 5 5 5 5 5 5 5 5 5 5 5 5 5 5 5 5 5 5 5 5 
5 5 5 5 5 5 5 5 5 5 5 5 5 5 5 5 5 5 5 5 5 5 5 5 5 5 5 5 5 5 5 5 5 5 5 5 5 5 5 5 
5 5 5 5 5 5 5 5 5 5 5 5 5 5 5 5 5 5 5 5 5 5 5 5 5 5 5 5 5 5 5 5 5 5 5 5 5 5 5 5 
5 5 5 5 5 5 5 5 5 5 5 5 5 5 5 5 5 5 5 5 5 5 5 5 5 5 5 5 5 5 5 5 5 5 5 5 5 5 5 5 
5 5 5 5 5 5 5 5 5 -92 5 5 5 5 5 5 5 5 5 -93 5 5 5 5 5 5 5 5 5 -94 5 5 5 5 5 5 5 5 5 -95 
