02 02 02 02 02 02 02 02 02 02
02 26 26 26 26 26 26 26 26 02
02 26 26 26 26 26 26 26 26 02
02 26 26 26 26 26 26 26 26 02 
02 26 26 26 26 26 26 26 26 02
02 26 26 26 26 26 26 26 26 02
02 26 26 26 26 26 26 26 26 02
02 26 26 26 26 26 26 26 26 02
02 26 26 26 26 26 26 26 26 02
02 02 02 02 02 02 02 02 02 02
