5 5 -6 -6 -6 -6 -6 -6 -6 -6 -6 -6 -6 5 5 5 5 5 5 5 5 5 -6 -6 -6 -6 5 5 5 5 5 5 5 -6 -6 -6 5 5 5 5 
5 -6 -6 5 5 -6 5 5 5 -6 5 5 -6 -6 5 5 5 5 5 5 5 5 -6 5 5 -6 5 5 5 5 5 5 5 -6 5 -6 -6 5 5 5 
5 -6 5 5 5 5 5 5 5 5 5 5 5 -6 -6 -6 -6 -6 -6 -6 -6 -6 -6 5 5 -6 5 5 5 5 5 5 5 -6 5 5 -6 -6 -6 5 
5 -6 5 5 5 5 5 5 5 5 5 5 5 5 5 5 5 5 5 5 5 5 5 5 5 -6 5 5 5 5 5 5 5 -6 5 5 5 5 -6 -6 
5 -6 -6 5 5 5 5 5 5 5 5 5 5 -6 -6 -6 -6 -6 -6 -6 -6 -6 -6 5 5 -6 5 -6 -6 -6 5 5 5 -6 5 5 5 5 5 -6 
5 5 -6 -6 5 5 5 5 5 5 5 5 -6 -6 5 5 5 5 5 5 5 -6 -6 5 5 -6 5 -6 5 -6 5 5 5 -6 5 5 5 5 5 -6 
5 5 5 -6 -6 -6 -6 -6 -6 -6 -6 -6 -6 5 5 5 5 5 5 5 -6 -6 5 5 5 -6 -6 -6 5 -6 -6 -6 -6 -6 5 5 5 5 5 -6 
5 5 5 5 5 5 5 5 5 5 5 5 5 5 5 5 -6 -6 -6 -6 -6 5 5 5 5 5 5 5 5 5 5 5 5 5 5 5 5 5 5 -6 
5 5 5 5 5 5 5 5 5 -6 -6 -6 -6 -6 -6 -6 -6 5 5 5 5 5 5 5 5 5 5 5 5 5 5 5 5 5 5 5 5 5 5 -6 
5 5 5 5 5 5 5 5 -6 49 5 5 5 5 5 5 5 5 5 50 5 5 5 5 5 5 5 5 5 51 5 5 5 5 5 5 5 5 5 -110 
5 5 5 5 5 5 5 5 -6 5 5 5 5 5 5 5 5 5 5 5 5 5 5 5 5 5 5 5 5 5 5 5 5 5 5 5 5 5 5 -6 
5 5 5 5 5 5 5 5 -6 5 5 5 5 -6 5 5 5 5 5 5 5 5 5 5 5 5 5 5 -6 5 5 5 5 5 5 5 5 5 5 -6 
5 5 5 5 5 5 5 5 -6 5 5 5 5 5 5 5 5 5 5 5 5 5 -6 5 5 5 5 5 5 5 5 5 5 5 5 5 5 5 5 -6 
5 5 5 5 5 5 5 5 -6 5 5 5 5 5 5 5 5 5 5 5 5 5 5 5 5 5 5 5 5 5 5 5 5 5 5 5 5 5 5 -6 
5 5 5 5 5 5 5 5 -6 5 5 5 5 5 5 5 5 5 -6 5 5 5 5 5 5 5 5 5 5 5 5 5 5 5 5 5 5 5 5 -6 
5 5 5 5 5 5 5 5 -6 5 5 5 5 5 5 5 5 5 5 5 5 5 5 5 5 5 5 5 5 5 5 5 5 5 5 5 5 5 5 -6 
5 5 5 5 5 5 5 5 -6 5 5 5 -6 5 5 5 5 5 5 5 5 5 5 5 5 5 5 5 5 5 5 5 5 5 5 5 5 5 5 -6 
5 5 5 5 5 5 5 5 -6 -6 5 5 5 5 5 5 5 5 5 5 5 5 5 5 5 5 5 5 5 5 5 5 5 5 5 5 5 5 5 -6 
5 5 5 5 5 5 5 5 5 5 -6 -6 -6 -6 -6 -6 -6 -6 -6 -6 -6 -6 -6 -6 -6 -6 -6 -6 -6 -6 -6 -6 -6 -6 5 5 5 5 5 -6 
5 5 5 5 5 5 5 5 5 -111 5 5 5 5 5 5 5 5 5 -112 5 5 5 5 5 5 5 5 5 -113 5 5 5 -6 -6 5 5 5 5 -114 
5 5 -6 -6 -6 -6 -6 -6 -6 -6 -6 -6 -6 -6 -6 -6 -6 -6 5 5 5 5 5 5 5 5 5 5 5 5 5 5 5 5 -6 5 5 5 5 -6 
5 -6 -6 5 5 5 5 5 5 5 5 5 5 5 5 5 5 -6 -6 5 5 -6 -6 -6 -6 -6 -6 5 5 5 5 5 5 -6 -6 5 5 5 5 -6 
-6 -6 5 5 5 5 5 5 5 5 5 5 5 5 5 5 5 5 -6 -6 -6 -6 5 5 5 5 -6 -6 5 5 5 5 -6 -6 5 5 5 5 5 -6 
-6 5 5 -6 -6 -6 -6 5 -6 -6 -6 5 -6 -6 -6 -6 5 5 5 -6 -6 5 5 5 5 5 5 -6 -6 -6 -6 -6 -6 5 5 5 5 5 5 -6 
-6 5 5 -6 5 5 5 5 5 5 5 5 5 5 5 -6 5 5 5 -6 -6 5 5 5 5 5 5 5 5 5 5 5 5 5 5 5 5 5 5 -6 
5 -6 5 -6 5 5 5 5 5 5 5 5 5 5 5 -6 5 -6 -6 -6 -6 5 5 5 5 5 5 5 5 5 5 5 5 5 5 5 5 5 5 -6 
5 -6 5 5 5 5 5 5 5 5 5 5 5 5 5 5 5 5 -6 5 -6 5 5 5 5 5 5 5 5 5 5 5 5 5 5 5 5 5 5 -6 
5 -6 5 5 5 5 5 5 5 5 5 5 5 5 5 5 5 5 -6 5 -6 5 5 5 5 5 5 5 5 5 5 5 5 5 5 5 5 5 5 -6 
5 -6 5 5 5 5 5 5 5 5 5 5 5 5 5 5 5 5 -6 5 -6 5 5 5 -6 5 5 5 5 5 5 5 5 5 5 5 5 5 -6 -6 
5 -6 5 5 5 5 5 5 5 52 5 5 5 5 5 5 5 5 -6 -115 -6 5 5 5 5 5 5 5 5 53 5 5 5 5 5 5 5 5 5 -116 
5 -6 5 5 5 5 5 5 5 5 5 5 5 5 5 5 5 5 -6 5 -6 5 5 5 5 5 5 5 5 5 5 5 5 5 5 5 5 5 5 -6 
5 -6 5 5 5 5 5 5 5 5 5 5 5 5 5 5 5 5 -6 5 -6 5 5 5 5 5 5 5 5 5 5 5 5 5 5 5 5 5 5 -6 
5 -6 5 5 5 5 5 5 5 5 5 5 5 5 5 5 5 5 -6 5 -6 5 5 5 5 5 5 5 5 5 5 5 5 5 5 5 5 5 5 -6 
5 -6 5 5 5 5 5 5 5 5 5 5 5 5 5 5 5 -6 -6 5 -6 5 5 -6 5 5 5 5 5 5 5 -6 5 5 5 5 5 5 5 -6 
5 -6 -6 -6 5 5 5 5 5 5 5 5 5 5 -6 -6 -6 -6 5 5 -6 5 5 5 5 5 5 5 5 5 5 5 5 5 5 5 -6 5 5 -6 
5 5 5 -6 5 5 5 5 5 5 5 5 5 5 -6 5 5 5 5 5 -6 5 5 5 5 5 5 5 5 5 5 5 5 5 5 5 5 5 5 -6 
5 5 5 -6 5 5 5 5 5 5 5 5 5 5 -6 5 5 5 5 5 -6 -6 5 -6 -6 -6 -6 -6 -6 5 5 5 5 5 5 5 5 5 5 -6 
5 5 5 -6 5 5 5 5 5 5 5 5 5 5 -6 5 5 5 5 5 5 -6 -6 -6 5 5 5 5 -6 5 5 5 5 5 5 5 5 5 5 -6 
5 5 5 -6 -6 -6 5 5 -6 -6 5 5 5 5 -6 5 5 5 5 5 5 5 5 5 5 5 5 5 -6 5 5 5 5 5 5 5 -6 5 5 -6 
5 5 5 5 5 5 5 5 5 -117 -6 -6 -6 -6 -6 5 5 5 5 -118 5 5 5 5 5 5 5 5 -6 -119 -6 -6 -6 -6 -6 -6 -6 -6 -6 -120 
