5 5 5 5 5 5 -6 -6 -6 -6 -6 -6 -6 -6 -6 -6 -6 -6 -6 -6 5 5 5 5 5 5 5 5 5 5 5 5 5 5 5 5 5 5 5 5 5 5 5 5 5 5 5 5 5 5 
-6 -6 -6 -6 -6 -6 5 5 5 5 5 -6 5 5 5 -6 5 5 5 5 5 -6 5 -6 5 5 5 5 5 5 5 5 5 5 5 5 5 5 5 5 5 5 5 5 5 5 5 5 5 5 
5 -6 5 -6 5 -6 5 5 5 5 5 -6 5 5 5 -6 5 5 5 5 -6 5 -6 5 -6 -6 -6 -6 5 5 5 5 5 5 5 5 5 5 5 5 5 5 5 5 5 5 5 5 5 5 
5 -6 5 -6 5 -6 5 5 5 5 5 -6 -6 5 -6 -6 5 5 5 5 -6 5 -6 5 -6 5 5 -6 -6 5 5 5 5 5 5 5 5 5 5 5 5 5 5 5 5 5 5 5 5 5 
5 -6 5 -6 5 -6 5 5 5 5 5 5 5 5 5 5 5 5 5 5 -6 5 -6 5 -6 5 5 5 -6 5 5 5 5 5 5 5 5 5 5 5 5 5 5 5 5 5 5 5 5 5 
5 -6 5 -6 5 -6 -6 -6 -6 -6 -6 5 -6 -6 -6 5 -6 -6 -6 -6 -6 5 -6 5 -6 -6 5 5 -6 5 5 5 5 5 5 5 5 5 5 5 5 5 5 5 5 5 5 5 5 5 
5 -6 5 -6 5 5 5 5 5 5 5 5 5 5 5 5 5 5 5 5 5 5 -6 5 -6 5 5 5 -6 5 5 5 5 5 5 5 5 5 5 5 5 5 5 5 5 5 5 5 5 5 
5 -6 5 -6 -6 5 -6 -6 -6 -6 -6 -6 -6 -6 -6 -6 -6 -6 -6 -6 5 -6 -6 5 -6 5 5 5 -6 5 5 5 5 5 5 5 5 5 5 5 5 5 5 5 5 5 5 5 5 5 
5 -6 5 5 5 5 5 5 5 5 5 5 5 5 5 5 5 5 5 5 5 5 5 5 -6 5 5 5 -6 5 5 5 5 5 5 5 5 5 5 5 5 5 5 5 5 5 5 5 5 5 
5 -6 5 5 5 5 5 5 5 25 5 5 5 5 5 5 5 5 5 -41 5 5 5 5 -6 -6 5 5 -6 -45 5 5 5 5 5 5 5 5 5 5 5 5 5 5 5 5 5 5 5 5 
5 -6 -6 -6 -6 -6 -6 -6 -6 -6 -6 -6 5 5 5 -6 -6 -6 -6 -6 -6 -6 -6 -6 -6 -6 5 5 -6 5 5 5 5 5 5 5 5 5 5 5 5 5 5 5 5 5 5 5 5 5 
-6 5 5 5 5 5 5 5 5 5 5 5 5 5 5 5 5 5 5 5 5 5 5 5 5 5 5 5 -6 5 5 5 5 5 5 5 5 5 5 5 5 5 5 5 5 5 5 5 5 5 
-6 5 5 5 5 5 5 5 5 5 5 5 5 5 5 5 5 5 5 5 5 5 5 5 5 5 5 5 -6 5 5 5 5 5 5 5 5 5 5 5 5 5 5 5 5 5 5 5 5 5 
5 -6 -6 -6 5 5 5 5 5 5 5 5 5 5 5 5 5 5 5 5 5 5 5 5 5 5 5 5 -6 5 5 5 5 5 5 5 5 5 5 5 5 5 5 5 5 5 5 5 5 5 
5 5 5 -6 5 5 5 5 5 5 5 5 5 5 5 5 5 5 5 5 5 5 5 5 5 5 5 -6 -6 5 5 5 5 5 5 5 5 5 5 5 5 5 5 5 5 5 5 5 5 5 
5 5 -6 -6 5 5 5 5 5 5 5 5 5 5 5 5 5 -6 -6 -6 -6 -6 -6 -6 -6 -6 -6 -6 5 5 5 5 5 5 5 5 5 5 5 5 5 5 5 5 5 5 5 5 5 5 
5 -6 5 38 38 38 38 38 38 38 38 38 38 38 38 38 5 -6 5 5 5 5 5 5 5 5 5 5 5 5 5 5 5 5 5 5 5 5 5 5 5 5 5 5 5 5 5 5 5 5 
5 -6 5 38 38 38 38 38 38 38 38 38 38 38 38 38 5 -6 5 5 5 5 5 5 5 5 5 5 5 5 5 5 5 5 5 5 5 5 5 5 5 5 5 5 5 5 5 5 5 5 
5 -6 5 38 38 38 38 38 38 38 38 38 38 38 38 38 5 -6 5 5 5 5 5 5 5 5 5 5 5 5 5 5 5 5 5 5 5 5 5 5 5 5 5 5 5 5 5 5 5 5 
5 -6 5 38 38 38 38 38 38 26 38 38 38 38 38 38 5 -6 5 -40 5 5 5 5 5 5 5 5 5 -46 5 5 5 5 5 5 5 5 5 5 5 5 5 5 5 5 5 5 5 5 
5 -6 5 38 38 38 38 38 38 38 38 38 38 38 38 38 5 -6 5 5 5 5 5 5 5 5 5 5 5 5 5 5 5 5 5 5 5 5 5 5 5 5 5 5 5 5 5 5 5 5 
5 -6 5 38 38 38 38 38 38 38 38 38 38 38 38 38 5 -6 5 5 5 5 5 5 5 5 5 5 5 5 5 5 5 5 5 5 5 5 5 5 5 5 5 5 5 5 5 5 5 5 
5 -6 5 38 38 38 38 38 38 38 38 38 38 38 38 38 5 -6 5 5 5 5 5 5 5 5 5 5 5 5 5 5 5 5 5 5 5 5 5 5 5 5 5 5 5 5 5 5 5 5 
5 -6 5 38 38 38 38 38 38 38 38 38 38 38 38 38 5 -6 5 5 5 5 5 5 5 5 5 5 5 5 5 5 5 5 5 5 5 5 5 5 5 5 5 5 5 5 5 5 5 5 
5 -6 5 38 38 38 38 38 38 38 38 38 38 38 38 38 5 -6 5 5 5 5 5 5 5 5 5 5 5 5 5 5 5 5 5 5 5 5 5 5 5 5 5 5 5 5 5 5 5 5 
5 -6 5 38 38 38 38 38 38 38 38 38 38 38 38 38 5 -6 5 5 5 5 5 5 5 5 5 5 5 5 5 5 5 5 5 5 5 5 5 5 5 5 5 5 5 5 5 5 5 5 
5 -6 5 38 38 38 38 38 38 38 38 38 38 38 38 38 5 -6 5 5 5 5 5 5 5 5 5 5 5 5 5 5 5 5 5 5 5 5 5 5 5 5 5 5 5 5 5 5 5 5 
5 -6 5 38 38 38 38 38 38 38 38 38 38 38 38 38 5 -6 5 5 5 5 5 5 5 5 5 5 5 5 5 5 5 5 5 5 5 5 5 5 5 5 5 5 5 5 5 5 5 5 
5 -6 5 38 38 38 38 38 38 38 38 38 38 38 38 38 5 -6 5 5 5 5 5 5 5 5 5 5 5 5 5 5 5 5 5 5 5 5 5 5 5 5 5 5 5 5 5 5 5 5 
5 5 -6 -6 5 5 5 5 5 -39 5 5 5 5 5 -6 -6 5 5 -38 5 5 5 5 5 5 5 5 5 5 5 5 5 5 5 5 5 5 5 5 5 5 5 5 5 5 5 5 5 5 
5 5 5 -6 5 5 5 5 5 -6 5 5 5 5 5 -6 5 5 5 5 5 5 5 5 5 5 5 5 5 5 5 5 5 5 5 5 5 5 5 5 5 5 5 5 5 5 5 5 5 5 
5 5 5 -6 5 5 5 -6 -6 5 5 5 5 5 5 -6 5 5 5 5 5 5 5 5 5 5 5 5 5 5 5 5 5 5 5 5 5 5 5 5 5 5 5 5 5 5 5 5 5 5 
5 5 -6 5 5 5 5 -6 5 5 5 5 5 5 5 -6 -6 5 5 5 5 5 5 5 5 5 5 5 5 5 5 5 5 5 5 5 5 5 5 5 5 5 5 5 5 5 5 5 5 5 
5 -6 5 5 5 5 5 -6 5 5 5 5 -6 5 5 5 5 -6 5 5 5 5 5 5 5 5 5 5 5 5 5 5 5 5 5 5 5 5 5 5 5 5 5 5 5 5 5 5 5 5 
5 -6 5 5 5 5 5 -6 5 5 5 -6 5 -6 5 5 5 -6 5 5 5 5 5 5 5 5 5 5 5 5 5 5 5 5 5 5 5 5 5 5 5 5 5 5 5 5 5 5 5 5 
5 -6 5 5 5 -6 -6 -6 5 5 5 -6 5 -6 -6 5 5 5 -6 5 5 5 5 5 5 5 5 5 5 5 5 5 5 5 5 5 5 5 5 5 5 5 5 5 5 5 5 5 5 5 
5 -6 5 5 5 5 5 5 5 5 5 5 -6 5 5 5 5 5 5 -6 5 5 5 5 5 5 5 5 5 5 5 5 5 5 5 5 5 5 5 5 5 5 5 5 5 5 5 5 5 5 
-6 5 5 5 5 5 5 5 -6 5 5 5 5 5 5 5 5 5 5 -6 5 5 5 5 5 5 5 5 5 5 5 5 5 5 5 5 5 5 5 5 5 5 5 5 5 5 5 5 5 5 
-6 5 5 5 5 5 5 -6 5 5 5 5 5 5 5 5 5 5 5 -6 5 5 5 5 5 5 5 5 5 5 5 5 5 5 5 5 5 5 5 5 5 5 5 5 5 5 5 5 5 5 
-6 5 5 5 5 5 -6 -6 5 27 5 5 5 5 5 5 5 -6 -6 -42 5 5 5 5 5 5 5 5 5 5 5 5 5 5 5 5 5 5 5 5 5 5 5 5 5 5 5 5 5 5 
5 -6 5 5 5 5 -6 5 5 5 5 5 5 5 5 5 -6 5 5 -6 5 5 5 5 5 5 5 5 5 5 5 5 5 5 5 5 5 5 5 5 5 5 5 5 5 5 5 5 5 5 
-6 5 5 5 5 5 -6 5 5 5 5 5 5 5 5 5 -6 5 5 -6 5 5 5 5 5 5 5 5 5 5 5 5 5 5 5 5 5 5 5 5 5 5 5 5 5 5 5 5 5 5 
-6 5 5 -6 -6 -6 5 5 5 5 5 5 5 5 5 5 5 -6 5 -6 5 5 5 5 5 5 5 5 5 5 5 5 5 5 5 5 5 5 5 5 5 5 5 5 5 5 5 5 5 5 
-6 5 5 5 5 5 5 5 5 5 5 5 5 5 5 5 5 5 -6 -6 5 5 5 5 5 5 5 5 5 5 5 5 5 5 5 5 5 5 5 5 5 5 5 5 5 5 5 5 5 5 
-6 5 5 5 5 5 5 5 5 5 5 5 5 5 5 5 5 5 5 -6 5 5 5 5 5 5 5 5 5 5 5 5 5 5 5 5 5 5 5 5 5 5 5 5 5 5 5 5 5 5 
-6 5 5 5 5 5 5 5 5 5 5 5 5 5 5 5 5 5 5 -6 5 5 5 5 5 5 5 5 5 5 5 5 5 5 5 5 5 5 5 5 5 5 5 5 5 5 5 5 5 5 
-6 5 5 5 5 5 5 5 5 5 5 5 5 5 5 5 5 5 5 -6 5 5 5 5 5 5 5 5 5 5 5 5 5 5 5 5 5 5 5 5 5 5 5 5 5 5 5 5 5 5 
-6 5 5 5 5 5 5 5 5 5 5 5 5 5 5 5 5 5 5 -6 5 5 5 5 5 5 5 5 5 5 5 5 5 5 5 5 5 5 5 5 5 5 5 5 5 5 5 5 5 5 
-6 5 5 5 5 5 5 5 5 5 5 5 5 5 5 5 5 5 5 -6 5 5 5 5 5 5 5 5 5 5 5 5 5 5 5 5 5 5 5 5 5 5 5 5 5 5 5 5 5 5 
-6 -6 -6 -6 -6 -6 -6 -6 -6 -43 -6 -6 -6 -6 -6 -6 -6 -6 -6 -44 5 5 5 5 5 5 5 5 5 5 5 5 5 5 5 5 5 5 5 5 5 5 5 5 5 5 5 5 5 5 
